AAAACAACAGGCAGCTCCC -> AAACAACAGGCAGCTCCCA
AAAACTAACGCGGTATCGT -> AAACTAACGCGGTATCGTA
AAAACTAGCACAGTTCACA -> AAACTAGCACAGTTCACAG
AAAACTAGTCAGACCTGTT -> AAACTAGTCAGACCTGTTC
AAAACTATGTACGAAGTGA -> AAACTATGTACGAAGTGAC
AAAATCCTGGGATACCATA -> AAATCCTGGGATACCATAA
AAAATGTTATGAGAAGGAG -> AAATGTTATGAGAAGGAGC
AAACAACAGGCAGCTCCCA -> AACAACAGGCAGCTCCCAG
AAACAGCGGGCCTTGAAGT -> AACAGCGGGCCTTGAAGTA
AAACATGTGACGGACTTCT -> AACATGTGACGGACTTCTT
AAACCCAATACTTGAGGTG -> AACCCAATACTTGAGGTGG
AAACGAGATGCCACACTAA -> AACGAGATGCCACACTAAT
AAACGAGCATTGAGAGAGA -> AACGAGCATTGAGAGAGAA
AAACTAACGCGGTATCGTA -> AACTAACGCGGTATCGTAT
AAACTACCCCAACGGCGGG -> AACTACCCCAACGGCGGGA
AAACTAGCACAGTTCACAG -> AACTAGCACAGTTCACAGA
AAACTAGTCAGACCTGTTC -> AACTAGTCAGACCTGTTCA
AAACTATGTACGAAGTGAC -> AACTATGTACGAAGTGACT
AAACTGAATCTACGTACTA -> AACTGAATCTACGTACTAG
AAACTGCGTGCACCTCCTT -> AACTGCGTGCACCTCCTTG
AAACTGGCCGCGGCATGTC -> AACTGGCCGCGGCATGTCA
AAACTGTAATACAGGAGAT -> AACTGTAATACAGGAGATG
AAACTTAAAATCCTGGGAT -> AACTTAAAATCCTGGGATA
AAAGAGCTATCGAGATACA -> AAGAGCTATCGAGATACAT
AAAGTAAACATGTGACGGA -> AAGTAAACATGTGACGGAC
AAATATGCCAGCTTCAGGC -> AATATGCCAGCTTCAGGCT
AAATCCTGGGATACCATAA -> AATCCTGGGATACCATAAG
AAATGTTATGAGAAGGAGC -> AATGTTATGAGAAGGAGCT
AACAAAGAGCTATCGAGAT -> ACAAAGAGCTATCGAGATA
AACAACAGGCAGCTCCCAG -> ACAACAGGCAGCTCCCAGT
AACAAGGGCCGGAGCCTCT -> ACAAGGGCCGGAGCCTCTG
AACACCAATTTGAAGGCAG -> ACACCAATTTGAAGGCAGT
AACAGCGGCGCCTTACTAA -> ACAGCGGCGCCTTACTAAA
AACAGCGGGCCTTGAAGTA -> ACAGCGGGCCTTGAAGTAC
AACAGGCAGCTCCCAGTAT -> ACAGGCAGCTCCCAGTATA
AACAGGCGACTAATTATTT -> ACAGGCGACTAATTATTTG
AACATAAATATGCCAGCTT -> ACATAAATATGCCAGCTTC
AACATGGACGGGAGGCGAC -> ACATGGACGGGAGGCGACC
AACATGTGACGGACTTCTT -> ACATGTGACGGACTTCTTT
AACCATCCCTGAGCAACGG -> ACCATCCCTGAGCAACGGT
AACCCAATACTTGAGGTGG -> ACCCAATACTTGAGGTGGG
AACCCAGCGGGGATGGTTG -> ACCCAGCGGGGATGGTTGG
AACCCTGGCCACACTGCAA -> ACCCTGGCCACACTGCAAA
AACCCTTGTAATTGAGGGT -> ACCCTTGTAATTGAGGGTG
AACCGGCCTATTTCAAACT -> ACCGGCCTATTTCAAACTG
AACCTCACCCACTGTAGGG -> ACCTCACCCACTGTAGGGA
AACGAGATGCCACACTAAT -> ACGAGATGCCACACTAATC
AACGAGCATTGAGAGAGAA -> ACGAGCATTGAGAGAGAAT
AACGAGCTCCGAGTGAAGT -> ACGAGCTCCGAGTGAAGTC
AACGATAACGGATTCATCC -> ACGATAACGGATTCATCCC
AACGCGGTATCGTATCCAC -> ACGCGGTATCGTATCCACT
AACGCTCGCACATCCGGGC -> ACGCTCGCACATCCGGGCC
AACGCTGTAATGACACTCG -> ACGCTGTAATGACACTCGT
AACGGATTCATCCCCGGGA -> ACGGATTCATCCCCGGGAT
AACGGCGGGAACGAGCTCC -> ACGGCGGGAACGAGCTCCG
AACGGGTTACTTAAACTAC -> ACGGGTTACTTAAACTACC
AACGGTCCCCGTAAGTCTT -> ACGGTCCCCGTAAGTCTTA
AACGGTTTGGTAAACAGCG -> ACGGTTTGGTAAACAGCGG
AACTAACGCGGTATCGTAT -> ACTAACGCGGTATCGTATC
AACTACCCCAACGGCGGGA -> ACTACCCCAACGGCGGGAA
AACTAGCACAGTTCACAGA -> ACTAGCACAGTTCACAGAT
AACTAGTCAGACCTGTTCA -> ACTAGTCAGACCTGTTCAG
AACTATGTACGAAGTGACT -> ACTATGTACGAAGTGACTT
AACTCATAATCATGAGTAT -> ACTCATAATCATGAGTATC
AACTCCCTAGTTATACCGC -> ACTCCCTAGTTATACCGCG
AACTCGTAAGGCATCGCGC -> ACTCGTAAGGCATCGCGCG
AACTCTTGAAGGCAATAAA -> ACTCTTGAAGGCAATAAAG
AACTGAATCTACGTACTAG -> ACTGAATCTACGTACTAGC
AACTGATCCTCATGGTCTA -> ACTGATCCTCATGGTCTAT
AACTGCGTGCACCTCCTTG -> ACTGCGTGCACCTCCTTGA
AACTGCTCAGGTACGAAGC -> ACTGCTCAGGTACGAAGCA
AACTGGCCGCGGCATGTCA -> ACTGGCCGCGGCATGTCAA
AACTGTAATACAGGAGATG -> ACTGTAATACAGGAGATGG
AACTTAAAATCCTGGGATA -> ACTTAAAATCCTGGGATAC
AAGAACGGTCCCCGTAAGT -> AGAACGGTCCCCGTAAGTC
AAGACATATCTGCACCAAT -> AGACATATCTGCACCAATA
AAGAGCTATCGAGATACAT -> AGAGCTATCGAGATACATC
AAGATTCTCCTTCGTAGCC -> AGATTCTCCTTCGTAGCCT
AAGCAGGATCCAAGGCGAG -> AGCAGGATCCAAGGCGAGA
AAGCATAAGCGAGACTCGG -> AGCATAAGCGAGACTCGGG
AAGCATGTCGTTAACAAAG -> AGCATGTCGTTAACAAAGA
AAGCGAGACTCGGGTTACT -> AGCGAGACTCGGGTTACTA
AAGCTGTCTCTGCTTGCCC -> AGCTGTCTCTGCTTGCCCC
AAGGAGCTGCCGCTGACGG -> AGGAGCTGCCGCTGACGGT
AAGGCAATAAAGTAAACAT -> AGGCAATAAAGTAAACATG
AAGGCAGTGTATTCGCTGG -> AGGCAGTGTATTCGCTGGT
AAGGCATCGCGCGAGGCGT -> AGGCATCGCGCGAGGCGTG
AAGGCATCTCCCTCGCGCA -> AGGCATCTCCCTCGCGCAT
AAGGCGAGATTAACGCTCG -> AGGCGAGATTAACGCTCGC
AAGGCGAGCCTCAACGATA -> AGGCGAGCCTCAACGATAA
AAGGGAAACTGCGTGCACC -> AGGGAAACTGCGTGCACCT
AAGGGCCGGAGCCTCTGCA -> AGGGCCGGAGCCTCTGCAA
AAGGGCGTAAAACTAGTCA -> AGGGCGTAAAACTAGTCAG
AAGGTGGGCCTCAGGAACC -> AGGTGGGCCTCAGGAACCC
AAGTAAACATGTGACGGAC -> AGTAAACATGTGACGGACT
AAGTACCAGCGTCCGCAAG -> AGTACCAGCGTCCGCAAGT
AAGTACTAAGTTTAACCCA -> AGTACTAAGTTTAACCCAG
AAGTCTATCCTAACTCGTA -> AGTCTATCCTAACTCGTAA
AAGTCTTAGCAATTTGCAA -> AGTCTTAGCAATTTGCAAA
AAGTGACTTGCGCGTTCCC -> AGTGACTTGCGCGTTCCCA
AAGTGATGGCAGGTAACTG -> AGTGATGGCAGGTAACTGC
AAGTGGAATCTGGCCACAC -> AGTGGAATCTGGCCACACT
AAGTTTAACCCAGCGGGGA -> AGTTTAACCCAGCGGGGAT
AAGTTTGTTTTAGCGCTCG -> AGTTTGTTTTAGCGCTCGT
AATAAAGTAAACATGTGAC -> ATAAAGTAAACATGTGACG
AATAATAGGTATGTCACAA -> ATAATAGGTATGTCACAAT
AATACAGGAGATGGACCGA -> ATACAGGAGATGGACCGAA
AATACCAATGGGCTTGGCA -> ATACCAATGGGCTTGGCAG
AATACGCATGGCCACACTG -> ATACGCATGGCCACACTGC
AATACGCTACAAGGTGGGC -> ATACGCTACAAGGTGGGCC
AATACTTGAGGTGGGATCG -> ATACTTGAGGTGGGATCGG
AATAGATCTGGGGGTTGTG -> ATAGATCTGGGGGTTGTGG
AATAGGGATCGACTGCTGC -> ATAGGGATCGACTGCTGCT
AATAGGTATGTCACAATCG -> ATAGGTATGTCACAATCGC
AATATAACTCATAATCATG -> ATATAACTCATAATCATGA
AATATACCATTGAGAGCAT -> ATATACCATTGAGAGCATA
AATATGCCAGCTTCAGGCT -> ATATGCCAGCTTCAGGCTG
AATCATGAGTATCCTACTG -> ATCATGAGTATCCTACTGG
AATCCTGGGATACCATAAG -> ATCCTGGGATACCATAAGG
AATCGAGCAGGCGCGGACC -> ATCGAGCAGGCGCGGACCA
AATCGCACTTGGGTCTATG -> ATCGCACTTGGGTCTATGA
AATCGCAGTACACGCTGGG -> ATCGCAGTACACGCTGGGT
AATCGCCAGTAAAACAACA -> ATCGCCAGTAAAACAACAG
AATCGCTGACAGGTCATAC -> ATCGCTGACAGGTCATACG
AATCGGGACTAGTTTATTC -> ATCGGGACTAGTTTATTCG
AATCGTCGTGGAGATGATC -> ATCGTCGTGGAGATGATCC
AATCTACGTACTAGCACTT -> ATCTACGTACTAGCACTTT
AATCTGCATACTGCATCAA -> ATCTGCATACTGCATCAAG
AATCTGGCCACACTGCAAA -> ATCTGGCCACACTGCAAAA
AATGAAACTTAAAATCCTG -> ATGAAACTTAAAATCCTGG
AATGACACTCGTCATGCGG -> ATGACACTCGTCATGCGGA
AATGCCGCTCGGGAAGCTG -> ATGCCGCTCGGGAAGCTGT
AATGGGCCTCACATGAGCT -> ATGGGCCTCACATGAGCTC
AATGGGCTTGGCAGCAGGA -> ATGGGCTTGGCAGCAGGAA
AATGGGGTTTACAATATAC -> ATGGGGTTTACAATATACC
AATGTCCATCCCCGGGATG -> ATGTCCATCCCCGGGATGG
AATGTTATGAGAAGGAGCT -> ATGTTATGAGAAGGAGCTG
AATTATTTGCATACCGTCT -> ATTATTTGCATACCGTCTA
AATTGAGGGTGGTGTTCTT -> ATTGAGGGTGGTGTTCTTT
AATTTCTATGATAACACCA -> ATTTCTATGATAACACCAA
AATTTGAAGGCAGTGTATT -> ATTTGAAGGCAGTGTATTC
AATTTGCAAACTGTAATAC -> ATTTGCAAACTGTAATACA
AATTTGGGCTGGGGTGGGT -> ATTTGGGCTGGGGTGGGTT
ACAAAGAGCTATCGAGATA -> CAAAGAGCTATCGAGATAC
ACAACAGGCAGCTCCCAGT -> CAACAGGCAGCTCCCAGTA
ACAAGAACGGTCCCCGTAA -> CAAGAACGGTCCCCGTAAG
ACAAGGGCCGGAGCCTCTG -> CAAGGGCCGGAGCCTCTGC
ACAAGGTGGGCCTCAGGAA -> CAAGGTGGGCCTCAGGAAC
ACAATATACCATTGAGAGC -> CAATATACCATTGAGAGCA
ACAATCGCACTTGGGTCTA -> CAATCGCACTTGGGTCTAT
ACAATCGCCAGTAAAACAA -> CAATCGCCAGTAAAACAAC
ACAATGTCCATCCCCGGGA -> CAATGTCCATCCCCGGGAT
ACAATTTCTATGATAACAC -> CAATTTCTATGATAACACC
ACACAATTTCTATGATAAC -> CACAATTTCTATGATAACA
ACACACGTCGGCCATGTTC -> CACACGTCGGCCATGTTCA
ACACCAATTTGAAGGCAGT -> CACCAATTTGAAGGCAGTG
ACACGCTGGGTCGCAAGAT -> CACGCTGGGTCGCAAGATT
ACACGTCGGCCATGTTCAA -> CACGTCGGCCATGTTCAAT
ACACTAATCGTCGTGGAGA -> CACTAATCGTCGTGGAGAT
ACACTCGTCATGCGGAATG -> CACTCGTCATGCGGAATGG
ACACTGCAAAACTAACGCG -> CACTGCAAAACTAACGCGG
ACACTGCAAAACTAGCACA -> CACTGCAAAACTAGCACAG
ACACTGCAAAACTATGTAC -> CACTGCAAAACTATGTACG
ACAGAGCACCAGTTACGAT -> CAGAGCACCAGTTACGATA
ACAGATCCCGGTCCCCTGG -> CAGATCCCGGTCCCCTGGA
ACAGCGGCGCCTTACTAAA -> CAGCGGCGCCTTACTAAAC
ACAGCGGGCCTTGAAGTAC -> CAGCGGGCCTTGAAGTACT
ACAGGAGATGGACCGAACG -> CAGGAGATGGACCGAACGG
ACAGGCAACCTCACCCACT -> CAGGCAACCTCACCCACTG
ACAGGCAGCTCCCAGTATA -> CAGGCAGCTCCCAGTATAC
ACAGGCGACTAATTATTTG -> CAGGCGACTAATTATTTGC
ACAGGTCATACGGCATCCC -> CAGGTCATACGGCATCCCC
ACAGTTCACAGATCCCGGT -> CAGTTCACAGATCCCGGTC
ACATAAATATGCCAGCTTC -> CATAAATATGCCAGCTTCA
ACATATCTGCACCAATATA -> CATATCTGCACCAATATAA
ACATCCCCGGGATGGTCCT -> CATCCCCGGGATGGTCCTA
ACATCCGGGCCATGTCCCG -> CATCCGGGCCATGTCCCGC
ACATGAGCTCCTACTTAAG -> CATGAGCTCCTACTTAAGC
ACATGGACGGGAGGCGACC -> CATGGACGGGAGGCGACCA
ACATGTGACGGACTTCTTT -> CATGTGACGGACTTCTTTT
ACCAACCGGCCTATTTCAA -> CCAACCGGCCTATTTCAAA
ACCAATACGCATGGCCACA -> CCAATACGCATGGCCACAC
ACCAATATAACTCATAATC -> CCAATATAACTCATAATCA
ACCAATGGGCTTGGCAGCA -> CCAATGGGCTTGGCAGCAG
ACCAATTTGAAGGCAGTGT -> CCAATTTGAAGGCAGTGTA
ACCAGCCAGAACAAGGGCC -> CCAGCCAGAACAAGGGCCG
ACCAGCGTCCGCAAGTTTG -> CCAGCGTCCGCAAGTTTGT
ACCAGTACGGAGTAACTCC -> CCAGTACGGAGTAACTCCC
ACCAGTTACGATAACGCTG -> CCAGTTACGATAACGCTGT
ACCATAAGGGCGTAAAACT -> CCATAAGGGCGTAAAACTA
ACCATCCCTGAGCAACGGT -> CCATCCCTGAGCAACGGTT
ACCATTGAGAGCATAATGG -> CCATTGAGAGCATAATGGG
ACCCAATACTTGAGGTGGG -> CCCAATACTTGAGGTGGGA
ACCCACTGTAGGGACTAGG -> CCCACTGTAGGGACTAGGG
ACCCAGCGGGGATGGTTGG -> CCCAGCGGGGATGGTTGGA
ACCCCAACGGCGGGAACGA -> CCCCAACGGCGGGAACGAG
ACCCGTCACTGAACTCTTG -> CCCGTCACTGAACTCTTGA
ACCCTGGCCACACTGCAAA -> CCCTGGCCACACTGCAAAA
ACCCTTGTAATTGAGGGTG -> CCCTTGTAATTGAGGGTGG
ACCGAACGGGTTACTTAAA -> CCGAACGGGTTACTTAAAC
ACCGCGCAGTAAGGCATCT -> CCGCGCAGTAAGGCATCTC
ACCGGCCTATTTCAAACTG -> CCGGCCTATTTCAAACTGG
ACCGTCTAGTGGCCACAGG -> CCGTCTAGTGGCCACAGGC
ACCGTTTTGGCGCGGCCGG -> CCGTTTTGGCGCGGCCGGG
ACCTCACCCACTGTAGGGA -> CCTCACCCACTGTAGGGAC
ACCTCCTTGATACCAGCCA -> CCTCCTTGATACCAGCCAG
ACCTGTTCAGGCGCTTGCA -> CCTGTTCAGGCGCTTGCAC
ACGAAACGAGCATTGAGAG -> CGAAACGAGCATTGAGAGA
ACGAAGCAGGATCCAAGGC -> CGAAGCAGGATCCAAGGCG
ACGAAGGCGAGCCTCAACG -> CGAAGGCGAGCCTCAACGA
ACGAAGTGACTTGCGCGTT -> CGAAGTGACTTGCGCGTTC
ACGACCGTTTTGGCGCGGC -> CGACCGTTTTGGCGCGGCC
ACGACGACGGTTTCGCGTG -> CGACGACGGTTTCGCGTGG
ACGACGGTTTCGCGTGGGT -> CGACGGTTTCGCGTGGGTG
ACGAGATGCCACACTAATC -> CGAGATGCCACACTAATCG
ACGAGCATTGAGAGAGAAT -> CGAGCATTGAGAGAGAATA
ACGAGCTCCGAGTGAAGTC -> CGAGCTCCGAGTGAAGTCT
ACGATAACGCTGTAATGAC -> CGATAACGCTGTAATGACA
ACGATAACGGATTCATCCC -> CGATAACGGATTCATCCCC
ACGCAGTAGAATACGCTAC -> CGCAGTAGAATACGCTACA
ACGCATGGCCACACTGCAA -> CGCATGGCCACACTGCAAA
ACGCGGTATCGTATCCACT -> CGCGGTATCGTATCCACTG
ACGCTACAAGGTGGGCCTC -> CGCTACAAGGTGGGCCTCA
ACGCTCGCACATCCGGGCC -> CGCTCGCACATCCGGGCCA
ACGCTGGGTCGCAAGATTC -> CGCTGGGTCGCAAGATTCT
ACGCTGTAATGACACTCGT -> CGCTGTAATGACACTCGTC
ACGGACGAAGGCGAGCCTC -> CGGACGAAGGCGAGCCTCA
ACGGACTTCTTTTTCCCAT -> CGGACTTCTTTTTCCCATG
ACGGAGTAACTCCCTAGTT -> CGGAGTAACTCCCTAGTTA
ACGGATTCATCCCCGGGAT -> CGGATTCATCCCCGGGATG
ACGGCATCCCCGGGATGGT -> CGGCATCCCCGGGATGGTC
ACGGCGGGAACGAGCTCCG -> CGGCGGGAACGAGCTCCGA
ACGGGAGGCGACCAACCGG -> CGGGAGGCGACCAACCGGC
ACGGGTACAAGAACGGTCC -> CGGGTACAAGAACGGTCCC
ACGGGTGACGCAGTAGAAT -> CGGGTGACGCAGTAGAATA
ACGGGTTACTTAAACTACC -> CGGGTTACTTAAACTACCC
ACGGTAGATGCCAATCGCT -> CGGTAGATGCCAATCGCTG
ACGGTCCCCGTAAGTCTTA -> CGGTCCCCGTAAGTCTTAG
ACGGTTCCATACTTTCATC -> CGGTTCCATACTTTCATCT
ACGGTTTCGCGTGGGTGCG -> CGGTTTCGCGTGGGTGCGC
ACGGTTTGGTAAACAGCGG -> CGGTTTGGTAAACAGCGGG
ACGTAAACGAGATGCCACA -> CGTAAACGAGATGCCACAC
ACGTACTAGCACTTTGCAT -> CGTACTAGCACTTTGCATA
ACGTCGGCCATGTTCAATA -> CGTCGGCCATGTTCAATAC
ACTAAACCCAATACTTGAG -> CTAAACCCAATACTTGAGG
ACTAACGCGGTATCGTATC -> CTAACGCGGTATCGTATCC
ACTAAGTTTAACCCAGCGG -> CTAAGTTTAACCCAGCGGG
ACTAATCGTCGTGGAGATG -> CTAATCGTCGTGGAGATGA
ACTAATTATTTGCATACCG -> CTAATTATTTGCATACCGT
ACTACCCCAACGGCGGGAA -> CTACCCCAACGGCGGGAAC
ACTAGCACAGTTCACAGAT -> CTAGCACAGTTCACAGATC
ACTAGCACTTTGCATATGA -> CTAGCACTTTGCATATGAA
ACTAGGCCGCCCATAATTT -> CTAGGCCGCCCATAATTTG
ACTAGGGATGCCTACGGGT -> CTAGGGATGCCTACGGGTA
ACTAGTCAGACCTGTTCAG -> CTAGTCAGACCTGTTCAGG
ACTAGTTTATTCGGTGCCC -> CTAGTTTATTCGGTGCCCT
ACTATGTACGAAGTGACTT -> CTATGTACGAAGTGACTTG
ACTCATAATCATGAGTATC -> CTCATAATCATGAGTATCC
ACTCCCTAGTTATACCGCG -> CTCCCTAGTTATACCGCGC
ACTCGGGTTACTAGGCCGC -> CTCGGGTTACTAGGCCGCC
ACTCGTAAGGCATCGCGCG -> CTCGTAAGGCATCGCGCGA
ACTCGTCATGCGGAATGGG -> CTCGTCATGCGGAATGGGG
ACTCTTGAAGGCAATAAAG -> CTCTTGAAGGCAATAAAGT
ACTGAACTCTTGAAGGCAA -> CTGAACTCTTGAAGGCAAT
ACTGAATCTACGTACTAGC -> CTGAATCTACGTACTAGCA
ACTGATCCTCATGGTCTAT -> CTGATCCTCATGGTCTATT
ACTGCAAAACTAACGCGGT -> CTGCAAAACTAACGCGGTA
ACTGCAAAACTAGCACAGT -> CTGCAAAACTAGCACAGTT
ACTGCAAAACTATGTACGA -> CTGCAAAACTATGTACGAA
ACTGCATCAAGTACCAGCG -> CTGCATCAAGTACCAGCGT
ACTGCGTGCACCTCCTTGA -> CTGCGTGCACCTCCTTGAT
ACTGCTCAGGTACGAAGCA -> CTGCTCAGGTACGAAGCAG
ACTGCTGCTGTCGAGCTCT -> CTGCTGCTGTCGAGCTCTC
ACTGGCCGCGGCATGTCAA -> CTGGCCGCGGCATGTCAAG
ACTGGCCTGCTAGCGACGA -> CTGGCCTGCTAGCGACGAA
ACTGGGGGGCAGCTTACAC -> CTGGGGGGCAGCTTACACA
ACTGTAATACAGGAGATGG -> CTGTAATACAGGAGATGGA
ACTGTAGGGACTAGGGATG -> CTGTAGGGACTAGGGATGC
ACTTAAAATCCTGGGATAC -> CTTAAAATCCTGGGATACC
ACTTAAACTACCCCAACGG -> CTTAAACTACCCCAACGGC
ACTTAAGCATGTCGTTAAC -> CTTAAGCATGTCGTTAACA
ACTTCTTTTTCCCATGGTG -> CTTCTTTTTCCCATGGTGC
ACTTGAGGTGGGATCGGAC -> CTTGAGGTGGGATCGGACG
ACTTGCGCGTTCCCAGGGT -> CTTGCGCGTTCCCAGGGTG
ACTTGGGTCTATGATAATC -> CTTGGGTCTATGATAATCG
ACTTTCATCTTATGCACGA -> CTTTCATCTTATGCACGAC
ACTTTGCATATGAAGCATA -> CTTTGCATATGAAGCATAA
AGAACAAGGGCCGGAGCCT -> GAACAAGGGCCGGAGCCTC
AGAACATAAATATGCCAGC -> GAACATAAATATGCCAGCT
AGAACGGTCCCCGTAAGTC -> GAACGGTCCCCGTAAGTCT
AGAAGGAGCTGCCGCTGAC -> GAAGGAGCTGCCGCTGACG
AGAATACGCTACAAGGTGG -> GAATACGCTACAAGGTGGG
AGAATAGATCTGGGGGTTG -> GAATAGATCTGGGGGTTGT
AGACATATCTGCACCAATA -> GACATATCTGCACCAATAT
AGACCTGTTCAGGCGCTTG -> GACCTGTTCAGGCGCTTGC
AGACTCGGGTTACTAGGCC -> GACTCGGGTTACTAGGCCG
AGAGAATAGATCTGGGGGT -> GAGAATAGATCTGGGGGTT
AGAGAGAATAGATCTGGGG -> GAGAGAATAGATCTGGGGG
AGAGCACCAGTTACGATAA -> GAGCACCAGTTACGATAAC
AGAGCATAATGGGCCTCAC -> GAGCATAATGGGCCTCACA
AGAGCGGGGGTTGTCGGTG -> GAGCGGGGGTTGTCGGTGG
AGAGCTATCGAGATACATC -> GAGCTATCGAGATACATCC
AGATACATCCCCGGGATGG -> GATACATCCCCGGGATGGT
AGATCCCGGTCCCCTGGAG -> GATCCCGGTCCCCTGGAGG
AGATCTGGGGGTTGTGGAA -> GATCTGGGGGTTGTGGAAC
AGATGATCCCTCCTTTGAA -> GATGATCCCTCCTTTGAAT
AGATGCCAATCGCTGACAG -> GATGCCAATCGCTGACAGG
AGATGCCACACTAATCGTC -> GATGCCACACTAATCGTCG
AGATGGACCGAACGGGTTA -> GATGGACCGAACGGGTTAC
AGATTAACGCTCGCACATC -> GATTAACGCTCGCACATCC
AGATTCTCCTTCGTAGCCT -> GATTCTCCTTCGTAGCCTT
AGCAACGGTTTGGTAAACA -> GCAACGGTTTGGTAAACAG
AGCAATTTGCAAACTGTAA -> GCAATTTGCAAACTGTAAT
AGCACAGTTCACAGATCCC -> GCACAGTTCACAGATCCCG
AGCACCAGTTACGATAACG -> GCACCAGTTACGATAACGC
AGCACTTTGCATATGAAGC -> GCACTTTGCATATGAAGCA
AGCAGGAATAATAGGTATG -> GCAGGAATAATAGGTATGT
AGCAGGATCCAAGGCGAGA -> GCAGGATCCAAGGCGAGAT
AGCAGGCGCGGACCAGTAC -> GCAGGCGCGGACCAGTACG
AGCATAAGCGAGACTCGGG -> GCATAAGCGAGACTCGGGT
AGCATAATGGGCCTCACAT -> GCATAATGGGCCTCACATG
AGCATGTCGTTAACAAAGA -> GCATGTCGTTAACAAAGAG
AGCATTGAGAGAGAATAGA -> GCATTGAGAGAGAATAGAT
AGCCAGAACAAGGGCCGGA -> GCCAGAACAAGGGCCGGAG
AGCCATCCAACAGCGGCGC -> GCCATCCAACAGCGGCGCC
AGCCTCAACGATAACGGAT -> GCCTCAACGATAACGGATT
AGCCTCTGCAATGCCGCTC -> GCCTCTGCAATGCCGCTCG
AGCCTTACCCGTCACTGAA -> GCCTTACCCGTCACTGAAC
AGCGACGAAACGAGCATTG -> GCGACGAAACGAGCATTGA
AGCGAGACTCGGGTTACTA -> GCGAGACTCGGGTTACTAG
AGCGCTCGTGTGCCCAGAA -> GCGCTCGTGTGCCCAGAAC
AGCGGCGCCTTACTAAACC -> GCGGCGCCTTACTAAACCC
AGCGGGCCTTGAAGTACTA -> GCGGGCCTTGAAGTACTAA
AGCGGGGATGGTTGGATCT -> GCGGGGATGGTTGGATCTC
AGCGGGGGTTGTCGGTGGA -> GCGGGGGTTGTCGGTGGAT
AGCGTCCGCAAGTTTGTTT -> GCGTCCGCAAGTTTGTTTT
AGCTATCGAGATACATCCC -> GCTATCGAGATACATCCCC
AGCTCCCAGTATACGTAAA -> GCTCCCAGTATACGTAAAC
AGCTCCGAGTGAAGTCTAT -> GCTCCGAGTGAAGTCTATC
AGCTCCTACTTAAGCATGT -> GCTCCTACTTAAGCATGTC
AGCTCTCAGTGAAGGGAAA -> GCTCTCAGTGAAGGGAAAC
AGCTGCCGCTGACGGTAGA -> GCTGCCGCTGACGGTAGAT
AGCTGTCTCTGCTTGCCCC -> GCTGTCTCTGCTTGCCCCA
AGCTTACACAATTTCTATG -> GCTTACACAATTTCTATGA
AGCTTCAGGCTGTTGGCAA -> GCTTCAGGCTGTTGGCAAG
AGGAACCCTTGTAATTGAG -> GGAACCCTTGTAATTGAGG
AGGAATAATAGGTATGTCA -> GGAATAATAGGTATGTCAC
AGGAGATGGACCGAACGGG -> GGAGATGGACCGAACGGGT
AGGAGCTGCCGCTGACGGT -> GGAGCTGCCGCTGACGGTA
AGGATCCAAGGCGAGATTA -> GGATCCAAGGCGAGATTAA
AGGCAACCTCACCCACTGT -> GGCAACCTCACCCACTGTA
AGGCAATAAAGTAAACATG -> GGCAATAAAGTAAACATGT
AGGCAGCTCCCAGTATACG -> GGCAGCTCCCAGTATACGT
AGGCAGTGTATTCGCTGGT -> GGCAGTGTATTCGCTGGTC
AGGCATCGCGCGAGGCGTG -> GGCATCGCGCGAGGCGTGG
AGGCATCTCCCTCGCGCAT -> GGCATCTCCCTCGCGCATG
AGGCCGCCCATAATTTGGG -> GGCCGCCCATAATTTGGGC
AGGCGACCAACCGGCCTAT -> GGCGACCAACCGGCCTATT
AGGCGACTAATTATTTGCA -> GGCGACTAATTATTTGCAT
AGGCGAGATTAACGCTCGC -> GGCGAGATTAACGCTCGCA
AGGCGAGCCTCAACGATAA -> GGCGAGCCTCAACGATAAC
AGGCGCGGACCAGTACGGA -> GGCGCGGACCAGTACGGAG
AGGCGCTTGCACGACCGTT -> GGCGCTTGCACGACCGTTT
AGGCGTGGGGGCACGGACG -> GGCGTGGGGGCACGGACGA
AGGCTGTTGGCAAGACATA -> GGCTGTTGGCAAGACATAT
AGGGAAACTGCGTGCACCT -> GGGAAACTGCGTGCACCTC
AGGGACTAGGGATGCCTAC -> GGGACTAGGGATGCCTACG
AGGGATCGACTGCTGCTGT -> GGGATCGACTGCTGCTGTC
AGGGATGCCTACGGGTACA -> GGGATGCCTACGGGTACAA
AGGGCCGGAGCCTCTGCAA -> GGGCCGGAGCCTCTGCAAT
AGGGCGTAAAACTAGTCAG -> GGGCGTAAAACTAGTCAGA
AGGGTGACAATCGCACTTG -> GGGTGACAATCGCACTTGG
AGGGTGGTGTTCTTTCAAT -> GGGTGGTGTTCTTTCAATG
AGGGTGTCCCGGTTTTTTG -> GGGTGTCCCGGTTTTTTGA
AGGTAACTGCTCAGGTACG -> GGTAACTGCTCAGGTACGA
AGGTACGAAGCAGGATCCA -> GGTACGAAGCAGGATCCAA
AGGTATGTCACAATCGCCA -> GGTATGTCACAATCGCCAG
AGGTCATACGGCATCCCCG -> GGTCATACGGCATCCCCGG
AGGTGGGATCGGACGGGTG -> GGTGGGATCGGACGGGTGA
AGGTGGGCCTCAGGAACCC -> GGTGGGCCTCAGGAACCCT
AGGTGGGTTGTGGCTGCAA -> GGTGGGTTGTGGCTGCAAA
AGTAAAACAACAGGCAGCT -> GTAAAACAACAGGCAGCTC
AGTAAACATGTGACGGACT -> GTAAACATGTGACGGACTT
AGTAACTCCCTAGTTATAC -> GTAACTCCCTAGTTATACC
AGTAAGGCATCTCCCTCGC -> GTAAGGCATCTCCCTCGCG
AGTACACGCTGGGTCGCAA -> GTACACGCTGGGTCGCAAG
AGTACCAGCGTCCGCAAGT -> GTACCAGCGTCCGCAAGTT
AGTACGGAGTAACTCCCTA -> GTACGGAGTAACTCCCTAG
AGTACTAAGTTTAACCCAG -> GTACTAAGTTTAACCCAGC
AGTAGAATACGCTACAAGG -> GTAGAATACGCTACAAGGT
AGTATACGTAAACGAGATG -> GTATACGTAAACGAGATGC
AGTATCCTACTGGCCTGCT -> GTATCCTACTGGCCTGCTA
AGTCAGACCTGTTCAGGCG -> GTCAGACCTGTTCAGGCGC
AGTCTATCCTAACTCGTAA -> GTCTATCCTAACTCGTAAG
AGTCTTAGCAATTTGCAAA -> GTCTTAGCAATTTGCAAAC
AGTGAAGGGAAACTGCGTG -> GTGAAGGGAAACTGCGTGC
AGTGAAGTCTATCCTAACT -> GTGAAGTCTATCCTAACTC
AGTGACTTGCGCGTTCCCA -> GTGACTTGCGCGTTCCCAG
AGTGATGGCAGGTAACTGC -> GTGATGGCAGGTAACTGCT
AGTGGAATCTGGCCACACT -> GTGGAATCTGGCCACACTG
AGTGGCCACAGGCAACCTC -> GTGGCCACAGGCAACCTCA
AGTGTATTACAATGTCCAT -> GTGTATTACAATGTCCATC
AGTGTATTCGCTGGTCATA -> GTGTATTCGCTGGTCATAC
AGTTACGATAACGCTGTAA -> GTTACGATAACGCTGTAAT
AGTTATACCGCGCAGTAAG -> GTTATACCGCGCAGTAAGG
AGTTCACAGATCCCGGTCC -> GTTCACAGATCCCGGTCCC
AGTTGCGGTCAGGGTGTCC -> GTTGCGGTCAGGGTGTCCC
AGTTTAACCCAGCGGGGAT -> GTTTAACCCAGCGGGGATG
AGTTTAACCCTGGCCACAC -> GTTTAACCCTGGCCACACT
AGTTTATTCGGTGCCCTTC -> GTTTATTCGGTGCCCTTCA
AGTTTGTTTTAGCGCTCGT -> GTTTGTTTTAGCGCTCGTG
ATAAAGTAAACATGTGACG -> TAAAGTAAACATGTGACGG
ATAAATATGCCAGCTTCAG -> TAAATATGCCAGCTTCAGG
ATAACACCAATTTGAAGGC -> TAACACCAATTTGAAGGCA
ATAACGCTGTAATGACACT -> TAACGCTGTAATGACACTC
ATAACGGATTCATCCCCGG -> TAACGGATTCATCCCCGGG
ATAACTCATAATCATGAGT -> TAACTCATAATCATGAGTA
ATAAGCGAGACTCGGGTTA -> TAAGCGAGACTCGGGTTAC
ATAAGGGCGTAAAACTAGT -> TAAGGGCGTAAAACTAGTC
ATAATAGGTATGTCACAAT -> TAATAGGTATGTCACAATC
ATAATCATGAGTATCCTAC -> TAATCATGAGTATCCTACT
ATAATCGGGACTAGTTTAT -> TAATCGGGACTAGTTTATT
ATAATGGGCCTCACATGAG -> TAATGGGCCTCACATGAGC
ATAATTTGGGCTGGGGTGG -> TAATTTGGGCTGGGGTGGG
ATACAGAGCACCAGTTACG -> TACAGAGCACCAGTTACGA
ATACAGGAGATGGACCGAA -> TACAGGAGATGGACCGAAC
ATACATCCCCGGGATGGTC -> TACATCCCCGGGATGGTCC
ATACCAATGGGCTTGGCAG -> TACCAATGGGCTTGGCAGC
ATACCAGCCAGAACAAGGG -> TACCAGCCAGAACAAGGGC
ATACCATAAGGGCGTAAAA -> TACCATAAGGGCGTAAAAC
ATACCATTGAGAGCATAAT -> TACCATTGAGAGCATAATG
ATACCGCGCAGTAAGGCAT -> TACCGCGCAGTAAGGCATC
ATACCGTCTAGTGGCCACA -> TACCGTCTAGTGGCCACAG
ATACGCATGGCCACACTGC -> TACGCATGGCCACACTGCA
ATACGCTACAAGGTGGGCC -> TACGCTACAAGGTGGGCCT
ATACGGCATCCCCGGGATG -> TACGGCATCCCCGGGATGG
ATACGTAAACGAGATGCCA -> TACGTAAACGAGATGCCAC
ATACTGCATCAAGTACCAG -> TACTGCATCAAGTACCAGC
ATACTTGAGGTGGGATCGG -> TACTTGAGGTGGGATCGGA
ATACTTTCATCTTATGCAC -> TACTTTCATCTTATGCACG
ATAGATCTGGGGGTTGTGG -> TAGATCTGGGGGTTGTGGA
ATAGGGATCGACTGCTGCT -> TAGGGATCGACTGCTGCTG
ATAGGTATGTCACAATCGC -> TAGGTATGTCACAATCGCC
ATATAACTCATAATCATGA -> TATAACTCATAATCATGAG
ATATACCATTGAGAGCATA -> TATACCATTGAGAGCATAA
ATATCTGCACCAATATAAC -> TATCTGCACCAATATAACT
ATATGAAGCATAAGCGAGA -> TATGAAGCATAAGCGAGAC
ATATGCCAGCTTCAGGCTG -> TATGCCAGCTTCAGGCTGT
ATATGGCCTTACGGTTCCA -> TATGGCCTTACGGTTCCAT
ATCAAGTACCAGCGTCCGC -> TCAAGTACCAGCGTCCGCA
ATCATGAGTATCCTACTGG -> TCATGAGTATCCTACTGGC
ATCCAACAGCGGCGCCTTA -> TCCAACAGCGGCGCCTTAC
ATCCAAGGCGAGATTAACG -> TCCAAGGCGAGATTAACGC
ATCCACTGGGGGGCAGCTT -> TCCACTGGGGGGCAGCTTA
ATCCCCGGGATGGTCCTAC -> TCCCCGGGATGGTCCTACC
ATCCCCGGGATGGTCCTCG -> TCCCCGGGATGGTCCTCGG
ATCCCCGGGATGGTCCTGA -> TCCCCGGGATGGTCCTGAG
ATCCCCGGGATGGTCCTTA -> TCCCCGGGATGGTCCTTAA
ATCCCGGTCCCCTGGAGGT -> TCCCGGTCCCCTGGAGGTG
ATCCCTCCTTTGAATAGGG -> TCCCTCCTTTGAATAGGGA
ATCCCTGAGCAACGGTTTG -> TCCCTGAGCAACGGTTTGG
ATCCGGGCCATGTCCCGCA -> TCCGGGCCATGTCCCGCAT
ATCCTAACTCGTAAGGCAT -> TCCTAACTCGTAAGGCATC
ATCCTACTGGCCTGCTAGC -> TCCTACTGGCCTGCTAGCG
ATCCTCATGGTCTATTCGT -> TCCTCATGGTCTATTCGTG
ATCCTGGGATACCATAAGG -> TCCTGGGATACCATAAGGG
ATCGACTGCTGCTGTCGAG -> TCGACTGCTGCTGTCGAGC
ATCGAGATACATCCCCGGG -> TCGAGATACATCCCCGGGA
ATCGAGCAGGCGCGGACCA -> TCGAGCAGGCGCGGACCAG
ATCGCACTTGGGTCTATGA -> TCGCACTTGGGTCTATGAT
ATCGCAGTACACGCTGGGT -> TCGCAGTACACGCTGGGTC
ATCGCCAGTAAAACAACAG -> TCGCCAGTAAAACAACAGG
ATCGCGCGAGGCGTGGGGG -> TCGCGCGAGGCGTGGGGGC
ATCGCTGACAGGTCATACG -> TCGCTGACAGGTCATACGG
ATCGGACGGGTGACGCAGT -> TCGGACGGGTGACGCAGTA
ATCGGGACTAGTTTATTCG -> TCGGGACTAGTTTATTCGG
ATCGTATCCACTGGGGGGC -> TCGTATCCACTGGGGGGCA
ATCGTCGTGGAGATGATCC -> TCGTCGTGGAGATGATCCC
ATCGTTTCAACCATCCCTG -> TCGTTTCAACCATCCCTGA
ATCTACGTACTAGCACTTT -> TCTACGTACTAGCACTTTG
ATCTCCCTCGCGCATGGAT -> TCTCCCTCGCGCATGGATC
ATCTCTGAGAGCGGGGGTT -> TCTCTGAGAGCGGGGGTTG
ATCTGCACCAATATAACTC -> TCTGCACCAATATAACTCA
ATCTGCATACTGCATCAAG -> TCTGCATACTGCATCAAGT
ATCTGGCCACACTGCAAAA -> TCTGGCCACACTGCAAAAC
ATCTGGGGGTTGTGGAACA -> TCTGGGGGTTGTGGAACAG
ATCTTATGCACGACGACGG -> TCTTATGCACGACGACGGT
ATGAAACTTAAAATCCTGG -> TGAAACTTAAAATCCTGGG
ATGAAGCATAAGCGAGACT -> TGAAGCATAAGCGAGACTC
ATGACACTCGTCATGCGGA -> TGACACTCGTCATGCGGAA
ATGAGAAGGAGCTGCCGCT -> TGAGAAGGAGCTGCCGCTG
ATGAGCTCCTACTTAAGCA -> TGAGCTCCTACTTAAGCAT
ATGAGTATCCTACTGGCCT -> TGAGTATCCTACTGGCCTG
ATGATAACACCAATTTGAA -> TGATAACACCAATTTGAAG
ATGATAATCGGGACTAGTT -> TGATAATCGGGACTAGTTT
ATGATCCCTCCTTTGAATA -> TGATCCCTCCTTTGAATAG
ATGCACGACGACGGTTTCG -> TGCACGACGACGGTTTCGC
ATGCCAATCGCTGACAGGT -> TGCCAATCGCTGACAGGTC
ATGCCACACTAATCGTCGT -> TGCCACACTAATCGTCGTG
ATGCCAGCTTCAGGCTGTT -> TGCCAGCTTCAGGCTGTTG
ATGCCGCTCGGGAAGCTGT -> TGCCGCTCGGGAAGCTGTC
ATGCCTACGGGTACAAGAA -> TGCCTACGGGTACAAGAAC
ATGCGAGCCATCCAACAGC -> TGCGAGCCATCCAACAGCG
ATGCGGAATGGGGTTTACA -> TGCGGAATGGGGTTTACAA
ATGGACCGAACGGGTTACT -> TGGACCGAACGGGTTACTT
ATGGACGGGAGGCGACCAA -> TGGACGGGAGGCGACCAAC
ATGGATCGTTTCAACCATC -> TGGATCGTTTCAACCATCC
ATGGCAGGTAACTGCTCAG -> TGGCAGGTAACTGCTCAGG
ATGGCCACACTGCAAAACT -> TGGCCACACTGCAAAACTA
ATGGCCTTACGGTTCCATA -> TGGCCTTACGGTTCCATAC
ATGGGCCTCACATGAGCTC -> TGGGCCTCACATGAGCTCC
ATGGGCTTGGCAGCAGGAA -> TGGGCTTGGCAGCAGGAAT
ATGGGGTTTACAATATACC -> TGGGGTTTACAATATACCA
ATGGTCCTACCAATACGCA -> TGGTCCTACCAATACGCAT
ATGGTCCTCGGCGCCCCGT -> TGGTCCTCGGCGCCCCGTT
ATGGTCCTGAGTTTAACCC -> TGGTCCTGAGTTTAACCCT
ATGGTCCTTAAGTGGAATC -> TGGTCCTTAAGTGGAATCT
ATGGTCTATTCGTGGGAGT -> TGGTCTATTCGTGGGAGTT
ATGGTGCCGATTAATCTGC -> TGGTGCCGATTAATCTGCA
ATGGTTGGATCTCTGAGAG -> TGGTTGGATCTCTGAGAGC
ATGTACGAAGTGACTTGCG -> TGTACGAAGTGACTTGCGC
ATGTCAAGTGATGGCAGGT -> TGTCAAGTGATGGCAGGTA
ATGTCACAATCGCCAGTAA -> TGTCACAATCGCCAGTAAA
ATGTCCATCCCCGGGATGG -> TGTCCATCCCCGGGATGGT
ATGTCCCGCATTCAAAATG -> TGTCCCGCATTCAAAATGT
ATGTCGTTAACAAAGAGCT -> TGTCGTTAACAAAGAGCTA
ATGTGACGGACTTCTTTTT -> TGTGACGGACTTCTTTTTC
ATGTTATGAGAAGGAGCTG -> TGTTATGAGAAGGAGCTGC
ATGTTCAATACCAATGGGC -> TGTTCAATACCAATGGGCT
ATTAACGCTCGCACATCCG -> TTAACGCTCGCACATCCGG
ATTAATCTGCATACTGCAT -> TTAATCTGCATACTGCATC
ATTACAATGTCCATCCCCG -> TTACAATGTCCATCCCCGG
ATTATTTGCATACCGTCTA -> TTATTTGCATACCGTCTAG
ATTCAAAATGTTATGAGAA -> TTCAAAATGTTATGAGAAG
ATTCATCCCCGGGATGGTC -> TTCATCCCCGGGATGGTCC
ATTCGCTGGTCATACAGAG -> TTCGCTGGTCATACAGAGC
ATTCGGTGCCCTTCAACTG -> TTCGGTGCCCTTCAACTGA
ATTCGTGGGAGTTGCGGTC -> TTCGTGGGAGTTGCGGTCA
ATTCTCCTTCGTAGCCTTA -> TTCTCCTTCGTAGCCTTAC
ATTGAGAGAGAATAGATCT -> TTGAGAGAGAATAGATCTG
ATTGAGAGCATAATGGGCC -> TTGAGAGCATAATGGGCCT
ATTGAGGGTGGTGTTCTTT -> TTGAGGGTGGTGTTCTTTC
ATTTCAAACTGGCCGCGGC -> TTTCAAACTGGCCGCGGCA
ATTTCTATGATAACACCAA -> TTTCTATGATAACACCAAT
ATTTGAAGGCAGTGTATTC -> TTTGAAGGCAGTGTATTCG
ATTTGCAAACTGTAATACA -> TTTGCAAACTGTAATACAG
ATTTGCATACCGTCTAGTG -> TTTGCATACCGTCTAGTGG
ATTTGGGCTGGGGTGGGTT -> TTTGGGCTGGGGTGGGTTA
CAAAACTAACGCGGTATCG -> AAAACTAACGCGGTATCGT
CAAAACTAGCACAGTTCAC -> AAAACTAGCACAGTTCACA
CAAAACTATGTACGAAGTG -> AAAACTATGTACGAAGTGA
CAAAATGTTATGAGAAGGA -> AAAATGTTATGAGAAGGAG
CAAACTGAATCTACGTACT -> AAACTGAATCTACGTACTA
CAAACTGGCCGCGGCATGT -> AAACTGGCCGCGGCATGTC
CAAACTGTAATACAGGAGA -> AAACTGTAATACAGGAGAT
CAAAGAGCTATCGAGATAC -> AAAGAGCTATCGAGATACA
CAACAGCGGCGCCTTACTA -> AACAGCGGCGCCTTACTAA
CAACAGGCAGCTCCCAGTA -> AACAGGCAGCTCCCAGTAT
CAACCATCCCTGAGCAACG -> AACCATCCCTGAGCAACGG
CAACCGGCCTATTTCAAAC -> AACCGGCCTATTTCAAACT
CAACCTCACCCACTGTAGG -> AACCTCACCCACTGTAGGG
CAACGATAACGGATTCATC -> AACGATAACGGATTCATCC
CAACGGCGGGAACGAGCTC -> AACGGCGGGAACGAGCTCC
CAACGGTTTGGTAAACAGC -> AACGGTTTGGTAAACAGCG
CAACTGATCCTCATGGTCT -> AACTGATCCTCATGGTCTA
CAAGAACGGTCCCCGTAAG -> AAGAACGGTCCCCGTAAGT
CAAGACATATCTGCACCAA -> AAGACATATCTGCACCAAT
CAAGATTCTCCTTCGTAGC -> AAGATTCTCCTTCGTAGCC
CAAGGCGAGATTAACGCTC -> AAGGCGAGATTAACGCTCG
CAAGGGCCGGAGCCTCTGC -> AAGGGCCGGAGCCTCTGCA
CAAGGTGGGCCTCAGGAAC -> AAGGTGGGCCTCAGGAACC
CAAGTACCAGCGTCCGCAA -> AAGTACCAGCGTCCGCAAG
CAAGTGATGGCAGGTAACT -> AAGTGATGGCAGGTAACTG
CAAGTTTGTTTTAGCGCTC -> AAGTTTGTTTTAGCGCTCG
CAATAAAGTAAACATGTGA -> AATAAAGTAAACATGTGAC
CAATACCAATGGGCTTGGC -> AATACCAATGGGCTTGGCA
CAATACGCATGGCCACACT -> AATACGCATGGCCACACTG
CAATACTTGAGGTGGGATC -> AATACTTGAGGTGGGATCG
CAATATAACTCATAATCAT -> AATATAACTCATAATCATG
CAATATACCATTGAGAGCA -> AATATACCATTGAGAGCAT
CAATCGCACTTGGGTCTAT -> AATCGCACTTGGGTCTATG
CAATCGCCAGTAAAACAAC -> AATCGCCAGTAAAACAACA
CAATCGCTGACAGGTCATA -> AATCGCTGACAGGTCATAC
CAATGAAACTTAAAATCCT -> AATGAAACTTAAAATCCTG
CAATGCCGCTCGGGAAGCT -> AATGCCGCTCGGGAAGCTG
CAATGGGCTTGGCAGCAGG -> AATGGGCTTGGCAGCAGGA
CAATGTCCATCCCCGGGAT -> AATGTCCATCCCCGGGATG
CAATTTCTATGATAACACC -> AATTTCTATGATAACACCA
CAATTTGAAGGCAGTGTAT -> AATTTGAAGGCAGTGTATT
CAATTTGCAAACTGTAATA -> AATTTGCAAACTGTAATAC
CACAATCGCCAGTAAAACA -> ACAATCGCCAGTAAAACAA
CACAATTTCTATGATAACA -> ACAATTTCTATGATAACAC
CACACACGTCGGCCATGTT -> ACACACGTCGGCCATGTTC
CACACGTCGGCCATGTTCA -> ACACGTCGGCCATGTTCAA
CACACTAATCGTCGTGGAG -> ACACTAATCGTCGTGGAGA
CACACTGCAAAACTAACGC -> ACACTGCAAAACTAACGCG
CACACTGCAAAACTAGCAC -> ACACTGCAAAACTAGCACA
CACACTGCAAAACTATGTA -> ACACTGCAAAACTATGTAC
CACAGATCCCGGTCCCCTG -> ACAGATCCCGGTCCCCTGG
CACAGGCAACCTCACCCAC -> ACAGGCAACCTCACCCACT
CACAGTTCACAGATCCCGG -> ACAGTTCACAGATCCCGGT
CACATCCGGGCCATGTCCC -> ACATCCGGGCCATGTCCCG
CACATGAGCTCCTACTTAA -> ACATGAGCTCCTACTTAAG
CACCAATATAACTCATAAT -> ACCAATATAACTCATAATC
CACCAATTTGAAGGCAGTG -> ACCAATTTGAAGGCAGTGT
CACCAGTTACGATAACGCT -> ACCAGTTACGATAACGCTG
CACCCACTGTAGGGACTAG -> ACCCACTGTAGGGACTAGG
CACCTCCTTGATACCAGCC -> ACCTCCTTGATACCAGCCA
CACGACCGTTTTGGCGCGG -> ACGACCGTTTTGGCGCGGC
CACGACGACGGTTTCGCGT -> ACGACGACGGTTTCGCGTG
CACGCTGGGTCGCAAGATT -> ACGCTGGGTCGCAAGATTC
CACGGACGAAGGCGAGCCT -> ACGGACGAAGGCGAGCCTC
CACGTCGGCCATGTTCAAT -> ACGTCGGCCATGTTCAATA
CACTAATCGTCGTGGAGAT -> ACTAATCGTCGTGGAGATG
CACTCGTCATGCGGAATGG -> ACTCGTCATGCGGAATGGG
CACTGAACTCTTGAAGGCA -> ACTGAACTCTTGAAGGCAA
CACTGCAAAACTAACGCGG -> ACTGCAAAACTAACGCGGT
CACTGCAAAACTAGCACAG -> ACTGCAAAACTAGCACAGT
CACTGCAAAACTATGTACG -> ACTGCAAAACTATGTACGA
CACTGGGGGGCAGCTTACA -> ACTGGGGGGCAGCTTACAC
CACTGTAGGGACTAGGGAT -> ACTGTAGGGACTAGGGATG
CACTTGGGTCTATGATAAT -> ACTTGGGTCTATGATAATC
CACTTTGCATATGAAGCAT -> ACTTTGCATATGAAGCATA
CAGAACAAGGGCCGGAGCC -> AGAACAAGGGCCGGAGCCT
CAGAACATAAATATGCCAG -> AGAACATAAATATGCCAGC
CAGACCTGTTCAGGCGCTT -> AGACCTGTTCAGGCGCTTG
CAGAGCACCAGTTACGATA -> AGAGCACCAGTTACGATAA
CAGATCCCGGTCCCCTGGA -> AGATCCCGGTCCCCTGGAG
CAGCAGGAATAATAGGTAT -> AGCAGGAATAATAGGTATG
CAGCCAGAACAAGGGCCGG -> AGCCAGAACAAGGGCCGGA
CAGCGGCGCCTTACTAAAC -> AGCGGCGCCTTACTAAACC
CAGCGGGCCTTGAAGTACT -> AGCGGGCCTTGAAGTACTA
CAGCGGGGATGGTTGGATC -> AGCGGGGATGGTTGGATCT
CAGCGTCCGCAAGTTTGTT -> AGCGTCCGCAAGTTTGTTT
CAGCTCCCAGTATACGTAA -> AGCTCCCAGTATACGTAAA
CAGCTTACACAATTTCTAT -> AGCTTACACAATTTCTATG
CAGCTTCAGGCTGTTGGCA -> AGCTTCAGGCTGTTGGCAA
CAGGAACCCTTGTAATTGA -> AGGAACCCTTGTAATTGAG
CAGGAATAATAGGTATGTC -> AGGAATAATAGGTATGTCA
CAGGAGATGGACCGAACGG -> AGGAGATGGACCGAACGGG
CAGGATCCAAGGCGAGATT -> AGGATCCAAGGCGAGATTA
CAGGCAACCTCACCCACTG -> AGGCAACCTCACCCACTGT
CAGGCAGCTCCCAGTATAC -> AGGCAGCTCCCAGTATACG
CAGGCGACTAATTATTTGC -> AGGCGACTAATTATTTGCA
CAGGCGCGGACCAGTACGG -> AGGCGCGGACCAGTACGGA
CAGGCGCTTGCACGACCGT -> AGGCGCTTGCACGACCGTT
CAGGCTGTTGGCAAGACAT -> AGGCTGTTGGCAAGACATA
CAGGGTGACAATCGCACTT -> AGGGTGACAATCGCACTTG
CAGGGTGTCCCGGTTTTTT -> AGGGTGTCCCGGTTTTTTG
CAGGTAACTGCTCAGGTAC -> AGGTAACTGCTCAGGTACG
CAGGTACGAAGCAGGATCC -> AGGTACGAAGCAGGATCCA
CAGGTCATACGGCATCCCC -> AGGTCATACGGCATCCCCG
CAGTAAAACAACAGGCAGC -> AGTAAAACAACAGGCAGCT
CAGTAAGGCATCTCCCTCG -> AGTAAGGCATCTCCCTCGC
CAGTACACGCTGGGTCGCA -> AGTACACGCTGGGTCGCAA
CAGTACGGAGTAACTCCCT -> AGTACGGAGTAACTCCCTA
CAGTAGAATACGCTACAAG -> AGTAGAATACGCTACAAGG
CAGTATACGTAAACGAGAT -> AGTATACGTAAACGAGATG
CAGTGAAGGGAAACTGCGT -> AGTGAAGGGAAACTGCGTG
CAGTGTATTACAATGTCCA -> AGTGTATTACAATGTCCAT
CAGTGTATTCGCTGGTCAT -> AGTGTATTCGCTGGTCATA
CAGTTACGATAACGCTGTA -> AGTTACGATAACGCTGTAA
CAGTTCACAGATCCCGGTC -> AGTTCACAGATCCCGGTCC
CATAAATATGCCAGCTTCA -> ATAAATATGCCAGCTTCAG
CATAAGCGAGACTCGGGTT -> ATAAGCGAGACTCGGGTTA
CATAAGGGCGTAAAACTAG -> ATAAGGGCGTAAAACTAGT
CATAATCATGAGTATCCTA -> ATAATCATGAGTATCCTAC
CATAATGGGCCTCACATGA -> ATAATGGGCCTCACATGAG
CATAATTTGGGCTGGGGTG -> ATAATTTGGGCTGGGGTGG
CATACAGAGCACCAGTTAC -> ATACAGAGCACCAGTTACG
CATACCGTCTAGTGGCCAC -> ATACCGTCTAGTGGCCACA
CATACGGCATCCCCGGGAT -> ATACGGCATCCCCGGGATG
CATACTGCATCAAGTACCA -> ATACTGCATCAAGTACCAG
CATACTTTCATCTTATGCA -> ATACTTTCATCTTATGCAC
CATATCTGCACCAATATAA -> ATATCTGCACCAATATAAC
CATATGAAGCATAAGCGAG -> ATATGAAGCATAAGCGAGA
CATATGGCCTTACGGTTCC -> ATATGGCCTTACGGTTCCA
CATCAAGTACCAGCGTCCG -> ATCAAGTACCAGCGTCCGC
CATCCAACAGCGGCGCCTT -> ATCCAACAGCGGCGCCTTA
CATCCCCGGGATGGTCCTA -> ATCCCCGGGATGGTCCTAC
CATCCCCGGGATGGTCCTC -> ATCCCCGGGATGGTCCTCG
CATCCCCGGGATGGTCCTG -> ATCCCCGGGATGGTCCTGA
CATCCCCGGGATGGTCCTT -> ATCCCCGGGATGGTCCTTA
CATCCCTGAGCAACGGTTT -> ATCCCTGAGCAACGGTTTG
CATCCGGGCCATGTCCCGC -> ATCCGGGCCATGTCCCGCA
CATCGCGCGAGGCGTGGGG -> ATCGCGCGAGGCGTGGGGG
CATCTCCCTCGCGCATGGA -> ATCTCCCTCGCGCATGGAT
CATCTTATGCACGACGACG -> ATCTTATGCACGACGACGG
CATGAGCTCCTACTTAAGC -> ATGAGCTCCTACTTAAGCA
CATGAGTATCCTACTGGCC -> ATGAGTATCCTACTGGCCT
CATGCGGAATGGGGTTTAC -> ATGCGGAATGGGGTTTACA
CATGGACGGGAGGCGACCA -> ATGGACGGGAGGCGACCAA
CATGGATCGTTTCAACCAT -> ATGGATCGTTTCAACCATC
CATGGCCACACTGCAAAAC -> ATGGCCACACTGCAAAACT
CATGGTCTATTCGTGGGAG -> ATGGTCTATTCGTGGGAGT
CATGGTGCCGATTAATCTG -> ATGGTGCCGATTAATCTGC
CATGTCAAGTGATGGCAGG -> ATGTCAAGTGATGGCAGGT
CATGTCCCGCATTCAAAAT -> ATGTCCCGCATTCAAAATG
CATGTCGTTAACAAAGAGC -> ATGTCGTTAACAAAGAGCT
CATGTGACGGACTTCTTTT -> ATGTGACGGACTTCTTTTT
CATGTTCAATACCAATGGG -> ATGTTCAATACCAATGGGC
CATTCAAAATGTTATGAGA -> ATTCAAAATGTTATGAGAA
CATTGAGAGAGAATAGATC -> ATTGAGAGAGAATAGATCT
CATTGAGAGCATAATGGGC -> ATTGAGAGCATAATGGGCC
CCAACAGCGGCGCCTTACT -> CAACAGCGGCGCCTTACTA
CCAACCGGCCTATTTCAAA -> CAACCGGCCTATTTCAAAC
CCAACGGCGGGAACGAGCT -> CAACGGCGGGAACGAGCTC
CCAAGGCGAGATTAACGCT -> CAAGGCGAGATTAACGCTC
CCAATACGCATGGCCACAC -> CAATACGCATGGCCACACT
CCAATACTTGAGGTGGGAT -> CAATACTTGAGGTGGGATC
CCAATATAACTCATAATCA -> CAATATAACTCATAATCAT
CCAATCGCTGACAGGTCAT -> CAATCGCTGACAGGTCATA
CCAATGGGCTTGGCAGCAG -> CAATGGGCTTGGCAGCAGG
CCAATTTGAAGGCAGTGTA -> CAATTTGAAGGCAGTGTAT
CCACACTAATCGTCGTGGA -> CACACTAATCGTCGTGGAG
CCACACTGCAAAACTAACG -> CACACTGCAAAACTAACGC
CCACACTGCAAAACTAGCA -> CACACTGCAAAACTAGCAC
CCACACTGCAAAACTATAC -> CACACTGCAAAACTATACC
CCACACTGCAAAACTATGT -> CACACTGCAAAACTATGTA
CCACAGGCAACCTCACCCA -> CACAGGCAACCTCACCCAC
CCACTGGGGGGCAGCTTAC -> CACTGGGGGGCAGCTTACA
CCACTGTAGGGACTAGGGA -> CACTGTAGGGACTAGGGAT
CCAGAACAAGGGCCGGAGC -> CAGAACAAGGGCCGGAGCC
CCAGAACATAAATATGCCA -> CAGAACATAAATATGCCAG
CCAGCCAGAACAAGGGCCG -> CAGCCAGAACAAGGGCCGG
CCAGCGGGGATGGTTGGAT -> CAGCGGGGATGGTTGGATC
CCAGCGTCCGCAAGTTTGT -> CAGCGTCCGCAAGTTTGTT
CCAGCTTCAGGCTGTTGGC -> CAGCTTCAGGCTGTTGGCA
CCAGGGTGACAATCGCACT -> CAGGGTGACAATCGCACTT
CCAGTAAAACAACAGGCAG -> CAGTAAAACAACAGGCAGC
CCAGTACGGAGTAACTCCC -> CAGTACGGAGTAACTCCCT
CCAGTATACGTAAACGAGA -> CAGTATACGTAAACGAGAT
CCAGTGTATTACAATGTCC -> CAGTGTATTACAATGTCCA
CCAGTTACGATAACGCTGT -> CAGTTACGATAACGCTGTA
CCATAAGGGCGTAAAACTA -> CATAAGGGCGTAAAACTAG
CCATAATTTGGGCTGGGGT -> CATAATTTGGGCTGGGGTG
CCATACTTTCATCTTATGC -> CATACTTTCATCTTATGCA
CCATCCAACAGCGGCGCCT -> CATCCAACAGCGGCGCCTT
CCATCCCCGGGATGGTCCT -> CATCCCCGGGATGGTCCTC
CCATCCCTGAGCAACGGTT -> CATCCCTGAGCAACGGTTT
CCATGGTGCCGATTAATCT -> CATGGTGCCGATTAATCTG
CCATGTCCCGCATTCAAAA -> CATGTCCCGCATTCAAAAT
CCATGTTCAATACCAATGG -> CATGTTCAATACCAATGGG
CCATTGAGAGCATAATGGG -> CATTGAGAGCATAATGGGC
CCCAACGGCGGGAACGAGC -> CCAACGGCGGGAACGAGCT
CCCAATACTTGAGGTGGGA -> CCAATACTTGAGGTGGGAT
CCCACTGTAGGGACTAGGG -> CCACTGTAGGGACTAGGGA
CCCAGAACATAAATATGCC -> CCAGAACATAAATATGCCA
CCCAGCGGGGATGGTTGGA -> CCAGCGGGGATGGTTGGAT
CCCAGGGTGACAATCGCAC -> CCAGGGTGACAATCGCACT
CCCAGTATACGTAAACGAG -> CCAGTATACGTAAACGAGA
CCCAGTGTATTACAATGTC -> CCAGTGTATTACAATGTCC
CCCATAATTTGGGCTGGGG -> CCATAATTTGGGCTGGGGT
CCCATGGTGCCGATTAATC -> CCATGGTGCCGATTAATCT
CCCCAACGGCGGGAACGAG -> CCCAACGGCGGGAACGAGC
CCCCAGTGTATTACAATGT -> CCCAGTGTATTACAATGTC
CCCCGGGATGGTCCTACCA -> CCCGGGATGGTCCTACCAA
CCCCGGGATGGTCCTCGGC -> CCCGGGATGGTCCTCGGCG
CCCCGGGATGGTCCTGAGT -> CCCGGGATGGTCCTGAGTT
CCCCGGGATGGTCCTTAAG -> CCCGGGATGGTCCTTAAGT
CCCCGTAAGTCTTAGCAAT -> CCCGTAAGTCTTAGCAATT
CCCCGTTGGCCACACTGCA -> CCCGTTGGCCACACTGCAA
CCCCTGGAGGTGGGTTGTG -> CCCTGGAGGTGGGTTGTGG
CCCGCATTCAAAATGTTAT -> CCGCATTCAAAATGTTATG
CCCGGGATGGTCCTACCAA -> CCGGGATGGTCCTACCAAT
CCCGGGATGGTCCTCGGCG -> CCGGGATGGTCCTCGGCGC
CCCGGGATGGTCCTGAGTT -> CCGGGATGGTCCTGAGTTT
CCCGGGATGGTCCTTAAGT -> CCGGGATGGTCCTTAAGTG
CCCGGTCCCCTGGAGGTGG -> CCGGTCCCCTGGAGGTGGG
CCCGGTTTTTTGAATCGAG -> CCGGTTTTTTGAATCGAGC
CCCGTAAGTCTTAGCAATT -> CCGTAAGTCTTAGCAATTT
CCCGTCACTGAACTCTTGA -> CCGTCACTGAACTCTTGAA
CCCGTTGGCCACACTGCAA -> CCGTTGGCCACACTGCAAA
CCCTAGTTATACCGCGCAG -> CCTAGTTATACCGCGCAGT
CCCTCCTTTGAATAGGGAT -> CCTCCTTTGAATAGGGATC
CCCTCGCGCATGGATCGTT -> CCTCGCGCATGGATCGTTT
CCCTGAGCAACGGTTTGGT -> CCTGAGCAACGGTTTGGTA
CCCTGGAGGTGGGTTGTGG -> CCTGGAGGTGGGTTGTGGC
CCCTGGCCACACTGCAAAA -> CCTGGCCACACTGCAAAAC
CCCTTCAACTGATCCTCAT -> CCTTCAACTGATCCTCATG
CCCTTGTAATTGAGGGTGG -> CCTTGTAATTGAGGGTGGT
CCGAACGGGTTACTTAAAC -> CGAACGGGTTACTTAAACT
CCGAGTGAAGTCTATCCTA -> CGAGTGAAGTCTATCCTAA
CCGATTAATCTGCATACTG -> CGATTAATCTGCATACTGC
CCGCAAGTTTGTTTTAGCG -> CGCAAGTTTGTTTTAGCGC
CCGCATTCAAAATGTTATG -> CGCATTCAAAATGTTATGA
CCGCCCATAATTTGGGCTG -> CGCCCATAATTTGGGCTGG
CCGCGCAGTAAGGCATCTC -> CGCGCAGTAAGGCATCTCC
CCGCGGCATGTCAAGTGAT -> CGCGGCATGTCAAGTGATG
CCGCTCGGGAAGCTGTCTC -> CGCTCGGGAAGCTGTCTCT
CCGCTGACGGTAGATGCCA -> CGCTGACGGTAGATGCCAA
CCGGAGCCTCTGCAATGCC -> CGGAGCCTCTGCAATGCCG
CCGGCCTATTTCAAACTGG -> CGGCCTATTTCAAACTGGC
CCGGGATGGTCCTACCAAT -> CGGGATGGTCCTACCAATA
CCGGGATGGTCCTCGGCGC -> CGGGATGGTCCTCGGCGCC
CCGGGATGGTCCTGAGTTT -> CGGGATGGTCCTGAGTTTA
CCGGGATGGTCCTTAAGTG -> CGGGATGGTCCTTAAGTGG
CCGGGCATATGGCCTTACG -> CGGGCATATGGCCTTACGG
CCGGGCCATGTCCCGCATT -> CGGGCCATGTCCCGCATTC
CCGGTCCCCTGGAGGTGGG -> CGGTCCCCTGGAGGTGGGT
CCGGTTTTTTGAATCGAGC -> CGGTTTTTTGAATCGAGCA
CCGTAAGTCTTAGCAATTT -> CGTAAGTCTTAGCAATTTG
CCGTCACTGAACTCTTGAA -> CGTCACTGAACTCTTGAAG
CCGTCTAGTGGCCACAGGC -> CGTCTAGTGGCCACAGGCA
CCGTTGGCCACACTGCAAA -> CGTTGGCCACACTGCAAAA
CCGTTTTGGCGCGGCCGGG -> CGTTTTGGCGCGGCCGGGC
CCTAACTCGTAAGGCATCG -> CTAACTCGTAAGGCATCGC
CCTACCAATACGCATGGCC -> CTACCAATACGCATGGCCA
CCTACGGGTACAAGAACGG -> CTACGGGTACAAGAACGGT
CCTACTGGCCTGCTAGCGA -> CTACTGGCCTGCTAGCGAC
CCTACTTAAGCATGTCGTT -> CTACTTAAGCATGTCGTTA
CCTAGTTATACCGCGCAGT -> CTAGTTATACCGCGCAGTA
CCTATTTCAAACTGGCCGC -> CTATTTCAAACTGGCCGCG
CCTCAACGATAACGGATTC -> CTCAACGATAACGGATTCA
CCTCACATGAGCTCCTACT -> CTCACATGAGCTCCTACTT
CCTCACCCACTGTAGGGAC -> CTCACCCACTGTAGGGACT
CCTCAGGAACCCTTGTAAT -> CTCAGGAACCCTTGTAATT
CCTCATGGTCTATTCGTGG -> CTCATGGTCTATTCGTGGG
CCTCCTTGATACCAGCCAG -> CTCCTTGATACCAGCCAGA
CCTCCTTTGAATAGGGATC -> CTCCTTTGAATAGGGATCG
CCTCGCGCATGGATCGTTT -> CTCGCGCATGGATCGTTTC
CCTCGGCGCCCCGTTGGCC -> CTCGGCGCCCCGTTGGCCA
CCTCTGCAATGCCGCTCGG -> CTCTGCAATGCCGCTCGGG
CCTGAGCAACGGTTTGGTA -> CTGAGCAACGGTTTGGTAA
CCTGAGTTTAACCCTGGCC -> CTGAGTTTAACCCTGGCCA
CCTGCTAGCGACGAAACGA -> CTGCTAGCGACGAAACGAG
CCTGGAGGTGGGTTGTGGC -> CTGGAGGTGGGTTGTGGCT
CCTGGCCACACTGCAAAAC -> CTGGCCACACTGCAAAACT
CCTGGGATACCATAAGGGC -> CTGGGATACCATAAGGGCG
CCTGTTCAGGCGCTTGCAC -> CTGTTCAGGCGCTTGCACG
CCTTAAGTGGAATCTGGCC -> CTTAAGTGGAATCTGGCCA
CCTTACCCGTCACTGAACT -> CTTACCCGTCACTGAACTC
CCTTACGGTTCCATACTTT -> CTTACGGTTCCATACTTTC
CCTTACTAAACCCAATACT -> CTTACTAAACCCAATACTT
CCTTCAACTGATCCTCATG -> CTTCAACTGATCCTCATGG
CCTTCGTAGCCTTACCCGT -> CTTCGTAGCCTTACCCGTC
CCTTGAAGTACTAAGTTTA -> CTTGAAGTACTAAGTTTAA
CCTTGATACCAGCCAGAAC -> CTTGATACCAGCCAGAACA
CCTTGTAATTGAGGGTGGT -> CTTGTAATTGAGGGTGGTG
CCTTTGAATAGGGATCGAC -> CTTTGAATAGGGATCGACT
CGAAACGAGCATTGAGAGA -> GAAACGAGCATTGAGAGAG
CGAACGGGTTACTTAAACT -> GAACGGGTTACTTAAACTA
CGAAGCAGGATCCAAGGCG -> GAAGCAGGATCCAAGGCGA
CGAAGGCGAGCCTCAACGA -> GAAGGCGAGCCTCAACGAT
CGAAGTGACTTGCGCGTTC -> GAAGTGACTTGCGCGTTCC
CGACCAACCGGCCTATTTC -> GACCAACCGGCCTATTTCA
CGACCGTTTTGGCGCGGCC -> GACCGTTTTGGCGCGGCCG
CGACGAAACGAGCATTGAG -> GACGAAACGAGCATTGAGA
CGACGACGGTTTCGCGTGG -> GACGACGGTTTCGCGTGGG
CGACGGTTTCGCGTGGGTG -> GACGGTTTCGCGTGGGTGC
CGACTAATTATTTGCATAC -> GACTAATTATTTGCATACC
CGACTGCTGCTGTCGAGCT -> GACTGCTGCTGTCGAGCTC
CGAGACTCGGGTTACTAGG -> GAGACTCGGGTTACTAGGC
CGAGATACATCCCCGGGAT -> GAGATACATCCCCGGGATG
CGAGATGCCACACTAATCG -> GAGATGCCACACTAATCGT
CGAGATTAACGCTCGCACA -> GAGATTAACGCTCGCACAT
CGAGCAGGCGCGGACCAGT -> GAGCAGGCGCGGACCAGTA
CGAGCATTGAGAGAGAATA -> GAGCATTGAGAGAGAATAG
CGAGCCATCCAACAGCGGC -> GAGCCATCCAACAGCGGCG
CGAGCCTCAACGATAACGG -> GAGCCTCAACGATAACGGA
CGAGCTCCGAGTGAAGTCT -> GAGCTCCGAGTGAAGTCTA
CGAGCTCTCAGTGAAGGGA -> GAGCTCTCAGTGAAGGGAA
CGAGGCGTGGGGGCACGGA -> GAGGCGTGGGGGCACGGAC
CGAGTGAAGTCTATCCTAA -> GAGTGAAGTCTATCCTAAC
CGATAACGCTGTAATGACA -> GATAACGCTGTAATGACAC
CGATAACGGATTCATCCCC -> GATAACGGATTCATCCCCG
CGATTAATCTGCATACTGC -> GATTAATCTGCATACTGCA
CGCAAGATTCTCCTTCGTA -> GCAAGATTCTCCTTCGTAG
CGCAAGTTTGTTTTAGCGC -> GCAAGTTTGTTTTAGCGCT
CGCACACACGTCGGCCATG -> GCACACACGTCGGCCATGT
CGCACATCCGGGCCATGTC -> GCACATCCGGGCCATGTCC
CGCACTTGGGTCTATGATA -> GCACTTGGGTCTATGATAA
CGCAGTAAGGCATCTCCCT -> GCAGTAAGGCATCTCCCTC
CGCAGTACACGCTGGGTCG -> GCAGTACACGCTGGGTCGC
CGCAGTAGAATACGCTACA -> GCAGTAGAATACGCTACAA
CGCATGGATCGTTTCAACC -> GCATGGATCGTTTCAACCA
CGCATGGCCACACTGCAAA -> GCATGGCCACACTGCAAAA
CGCATTCAAAATGTTATGA -> GCATTCAAAATGTTATGAG
CGCCAGTAAAACAACAGGC -> GCCAGTAAAACAACAGGCA
CGCCCATAATTTGGGCTGG -> GCCCATAATTTGGGCTGGG
CGCCCCGTTGGCCACACTG -> GCCCCGTTGGCCACACTGC
CGCCTTACTAAACCCAATA -> GCCTTACTAAACCCAATAC
CGCGAGGCGTGGGGGCACG -> GCGAGGCGTGGGGGCACGG
CGCGCAGTAAGGCATCTCC -> GCGCAGTAAGGCATCTCCC
CGCGCATGGATCGTTTCAA -> GCGCATGGATCGTTTCAAC
CGCGCGAGGCGTGGGGGCA -> GCGCGAGGCGTGGGGGCAC
CGCGGACCAGTACGGAGTA -> GCGGACCAGTACGGAGTAA
CGCGGCATGTCAAGTGATG -> GCGGCATGTCAAGTGATGG
CGCGGCCGGGCATATGGCC -> GCGGCCGGGCATATGGCCT
CGCGGTATCGTATCCACTG -> GCGGTATCGTATCCACTGG
CGCGTGGGTGCGCACACAC -> GCGTGGGTGCGCACACACG
CGCGTTCCCAGGGTGACAA -> GCGTTCCCAGGGTGACAAT
CGCTACAAGGTGGGCCTCA -> GCTACAAGGTGGGCCTCAG
CGCTCGCACATCCGGGCCA -> GCTCGCACATCCGGGCCAT
CGCTCGGGAAGCTGTCTCT -> GCTCGGGAAGCTGTCTCTG
CGCTCGTGTGCCCAGAACA -> GCTCGTGTGCCCAGAACAT
CGCTGACAGGTCATACGGC -> GCTGACAGGTCATACGGCA
CGCTGACGGTAGATGCCAA -> GCTGACGGTAGATGCCAAT
CGCTGGGTCGCAAGATTCT -> GCTGGGTCGCAAGATTCTC
CGCTGGTCATACAGAGCAC -> GCTGGTCATACAGAGCACC
CGCTGTAATGACACTCGTC -> GCTGTAATGACACTCGTCA
CGCTTGCACGACCGTTTTG -> GCTTGCACGACCGTTTTGG
CGGAATGGGGTTTACAATA -> GGAATGGGGTTTACAATAT
CGGACCAGTACGGAGTAAC -> GGACCAGTACGGAGTAACT
CGGACGAAGGCGAGCCTCA -> GGACGAAGGCGAGCCTCAA
CGGACGGGTGACGCAGTAG -> GGACGGGTGACGCAGTAGA
CGGACTTCTTTTTCCCATG -> GGACTTCTTTTTCCCATGG
CGGAGCCTCTGCAATGCCG -> GGAGCCTCTGCAATGCCGC
CGGAGTAACTCCCTAGTTA -> GGAGTAACTCCCTAGTTAT
CGGATTCATCCCCGGGATG -> GGATTCATCCCCGGGATGG
CGGCATCCCCGGGATGGTC -> GGCATCCCCGGGATGGTCC
CGGCATGTCAAGTGATGGC -> GGCATGTCAAGTGATGGCA
CGGCCATGTTCAATACCAA -> GGCCATGTTCAATACCAAT
CGGCCGGGCATATGGCCTT -> GGCCGGGCATATGGCCTTA
CGGCCTATTTCAAACTGGC -> GGCCTATTTCAAACTGGCC
CGGCGCCCCGTTGGCCACA -> GGCGCCCCGTTGGCCACAC
CGGCGCCTTACTAAACCCA -> GGCGCCTTACTAAACCCAA
CGGCGGGAACGAGCTCCGA -> GGCGGGAACGAGCTCCGAG
CGGGAACGAGCTCCGAGTG -> GGGAACGAGCTCCGAGTGA
CGGGAAGCTGTCTCTGCTT -> GGGAAGCTGTCTCTGCTTG
CGGGACTAGTTTATTCGGT -> GGGACTAGTTTATTCGGTG
CGGGAGGCGACCAACCGGC -> GGGAGGCGACCAACCGGCC
CGGGATGGTCCTACCAATA -> GGGATGGTCCTACCAATAC
CGGGATGGTCCTCGGCGCC -> GGGATGGTCCTCGGCGCCC
CGGGATGGTCCTGAGTTTA -> GGGATGGTCCTGAGTTTAA
CGGGATGGTCCTTAAGTGG -> GGGATGGTCCTTAAGTGGA
CGGGCATATGGCCTTACGG -> GGGCATATGGCCTTACGGT
CGGGCCATGTCCCGCATTC -> GGGCCATGTCCCGCATTCA
CGGGCCTTGAAGTACTAAG -> GGGCCTTGAAGTACTAAGT
CGGGGATGGTTGGATCTCT -> GGGGATGGTTGGATCTCTG
CGGGGGTTGTCGGTGGATG -> GGGGGTTGTCGGTGGATGC
CGGGTACAAGAACGGTCCC -> GGGTACAAGAACGGTCCCC
CGGGTGACGCAGTAGAATA -> GGGTGACGCAGTAGAATAC
CGGGTTACTAGGCCGCCCA -> GGGTTACTAGGCCGCCCAT
CGGGTTACTTAAACTACCC -> GGGTTACTTAAACTACCCC
CGGTAGATGCCAATCGCTG -> GGTAGATGCCAATCGCTGA
CGGTATCGTATCCACTGGG -> GGTATCGTATCCACTGGGG
CGGTCAGGGTGTCCCGGTT -> GGTCAGGGTGTCCCGGTTT
CGGTCCCCGTAAGTCTTAG -> GGTCCCCGTAAGTCTTAGC
CGGTCCCCTGGAGGTGGGT -> GGTCCCCTGGAGGTGGGTT
CGGTGCCCTTCAACTGATC -> GGTGCCCTTCAACTGATCC
CGGTGGATGCGAGCCATCC -> GGTGGATGCGAGCCATCCA
CGGTTCCATACTTTCATCT -> GGTTCCATACTTTCATCTT
CGGTTTCGCGTGGGTGCGC -> GGTTTCGCGTGGGTGCGCA
CGGTTTGGTAAACAGCGGG -> GGTTTGGTAAACAGCGGGC
CGGTTTTTTGAATCGAGCA -> GGTTTTTTGAATCGAGCAG
CGTAAAACTAGTCAGACCT -> GTAAAACTAGTCAGACCTG
CGTAAACGAGATGCCACAC -> GTAAACGAGATGCCACACT
CGTAAGGCATCGCGCGAGG -> GTAAGGCATCGCGCGAGGC
CGTAAGTCTTAGCAATTTG -> GTAAGTCTTAGCAATTTGC
CGTACTAGCACTTTGCATA -> GTACTAGCACTTTGCATAT
CGTAGCCTTACCCGTCACT -> GTAGCCTTACCCGTCACTG
CGTATCCACTGGGGGGCAG -> GTATCCACTGGGGGGCAGC
CGTCACTGAACTCTTGAAG -> GTCACTGAACTCTTGAAGG
CGTCATGCGGAATGGGGTT -> GTCATGCGGAATGGGGTTT
CGTCCGCAAGTTTGTTTTA -> GTCCGCAAGTTTGTTTTAG
CGTCGGCCATGTTCAATAC -> GTCGGCCATGTTCAATACC
CGTCGTGGAGATGATCCCT -> GTCGTGGAGATGATCCCTC
CGTCTAGTGGCCACAGGCA -> GTCTAGTGGCCACAGGCAA
CGTGCACCTCCTTGATACC -> GTGCACCTCCTTGATACCA
CGTGGAGATGATCCCTCCT -> GTGGAGATGATCCCTCCTT
CGTGGGAGTTGCGGTCAGG -> GTGGGAGTTGCGGTCAGGG
CGTGGGGGCACGGACGAAG -> GTGGGGGCACGGACGAAGG
CGTGGGTGCGCACACACGT -> GTGGGTGCGCACACACGTC
CGTGTGCCCAGAACATAAA -> GTGTGCCCAGAACATAAAT
CGTTAACAAAGAGCTATCG -> GTTAACAAAGAGCTATCGA
CGTTCCCAGGGTGACAATC -> GTTCCCAGGGTGACAATCG
CGTTGGCCACACTGCAAAA -> GTTGGCCACACTGCAAAAC
CGTTTCAACCATCCCTGAG -> GTTTCAACCATCCCTGAGC
CGTTTTGGCGCGGCCGGGC -> GTTTTGGCGCGGCCGGGCA
CTAAACCCAATACTTGAGG -> TAAACCCAATACTTGAGGT
CTAACGCGGTATCGTATCC -> TAACGCGGTATCGTATCCA
CTAACTCGTAAGGCATCGC -> TAACTCGTAAGGCATCGCG
CTAAGTTTAACCCAGCGGG -> TAAGTTTAACCCAGCGGGG
CTAATCGTCGTGGAGATGA -> TAATCGTCGTGGAGATGAT
CTAATTATTTGCATACCGT -> TAATTATTTGCATACCGTC
CTACAAGGTGGGCCTCAGG -> TACAAGGTGGGCCTCAGGA
CTACCAATACGCATGGCCA -> TACCAATACGCATGGCCAC
CTACCCCAACGGCGGGAAC -> TACCCCAACGGCGGGAACG
CTACGGGTACAAGAACGGT -> TACGGGTACAAGAACGGTC
CTACGTACTAGCACTTTGC -> TACGTACTAGCACTTTGCA
CTACTGGCCTGCTAGCGAC -> TACTGGCCTGCTAGCGACG
CTACTTAAGCATGTCGTTA -> TACTTAAGCATGTCGTTAA
CTAGCACAGTTCACAGATC -> TAGCACAGTTCACAGATCC
CTAGCACTTTGCATATGAA -> TAGCACTTTGCATATGAAG
CTAGCGACGAAACGAGCAT -> TAGCGACGAAACGAGCATT
CTAGGCCGCCCATAATTTG -> TAGGCCGCCCATAATTTGG
CTAGGGATGCCTACGGGTA -> TAGGGATGCCTACGGGTAC
CTAGTCAGACCTGTTCAGG -> TAGTCAGACCTGTTCAGGC
CTAGTGGCCACAGGCAACC -> TAGTGGCCACAGGCAACCT
CTAGTTATACCGCGCAGTA -> TAGTTATACCGCGCAGTAA
CTAGTTTATTCGGTGCCCT -> TAGTTTATTCGGTGCCCTT
CTATCCTAACTCGTAAGGC -> TATCCTAACTCGTAAGGCA
CTATCGAGATACATCCCCG -> TATCGAGATACATCCCCGG
CTATGATAACACCAATTTG -> TATGATAACACCAATTTGA
CTATGATAATCGGGACTAG -> TATGATAATCGGGACTAGT
CTATGTACGAAGTGACTTG -> TATGTACGAAGTGACTTGC
CTATTCGTGGGAGTTGCGG -> TATTCGTGGGAGTTGCGGT
CTATTTCAAACTGGCCGCG -> TATTTCAAACTGGCCGCGG
CTCAACGATAACGGATTCA -> TCAACGATAACGGATTCAT
CTCACATGAGCTCCTACTT -> TCACATGAGCTCCTACTTA
CTCACCCACTGTAGGGACT -> TCACCCACTGTAGGGACTA
CTCAGGAACCCTTGTAATT -> TCAGGAACCCTTGTAATTG
CTCAGGTACGAAGCAGGAT -> TCAGGTACGAAGCAGGATC
CTCAGTGAAGGGAAACTGC -> TCAGTGAAGGGAAACTGCG
CTCATAATCATGAGTATCC -> TCATAATCATGAGTATCCT
CTCATGGTCTATTCGTGGG -> TCATGGTCTATTCGTGGGA
CTCCCAGTATACGTAAACG -> TCCCAGTATACGTAAACGA
CTCCCTAGTTATACCGCGC -> TCCCTAGTTATACCGCGCA
CTCCCTCGCGCATGGATCG -> TCCCTCGCGCATGGATCGT
CTCCGAGTGAAGTCTATCC -> TCCGAGTGAAGTCTATCCT
CTCCTACTTAAGCATGTCG -> TCCTACTTAAGCATGTCGT
CTCCTTCGTAGCCTTACCC -> TCCTTCGTAGCCTTACCCG
CTCCTTGATACCAGCCAGA -> TCCTTGATACCAGCCAGAA
CTCCTTTGAATAGGGATCG -> TCCTTTGAATAGGGATCGA
CTCGCACATCCGGGCCATG -> TCGCACATCCGGGCCATGT
CTCGCGCATGGATCGTTTC -> TCGCGCATGGATCGTTTCA
CTCGGCGCCCCGTTGGCCA -> TCGGCGCCCCGTTGGCCAC
CTCGGGAAGCTGTCTCTGC -> TCGGGAAGCTGTCTCTGCT
CTCGGGTTACTAGGCCGCC -> TCGGGTTACTAGGCCGCCC
CTCGTAAGGCATCGCGCGA -> TCGTAAGGCATCGCGCGAG
CTCGTCATGCGGAATGGGG -> TCGTCATGCGGAATGGGGT
CTCGTGTGCCCAGAACATA -> TCGTGTGCCCAGAACATAA
CTCTCAGTGAAGGGAAACT -> TCTCAGTGAAGGGAAACTG
CTCTGAGAGCGGGGGTTGT -> TCTGAGAGCGGGGGTTGTC
CTCTGCAATGCCGCTCGGG -> TCTGCAATGCCGCTCGGGA
CTCTGCTTGCCCCAGTGTA -> TCTGCTTGCCCCAGTGTAT
CTCTTGAAGGCAATAAAGT -> TCTTGAAGGCAATAAAGTA
CTGAACTCTTGAAGGCAAT -> TGAACTCTTGAAGGCAATA
CTGAATCTACGTACTAGCA -> TGAATCTACGTACTAGCAC
CTGACAGGTCATACGGCAT -> TGACAGGTCATACGGCATC
CTGACGGTAGATGCCAATC -> TGACGGTAGATGCCAATCG
CTGAGAGCGGGGGTTGTCG -> TGAGAGCGGGGGTTGTCGG
CTGAGCAACGGTTTGGTAA -> TGAGCAACGGTTTGGTAAA
CTGAGTTTAACCCTGGCCA -> TGAGTTTAACCCTGGCCAC
CTGATCCTCATGGTCTATT -> TGATCCTCATGGTCTATTC
CTGCAAAACTAACGCGGTA -> TGCAAAACTAACGCGGTAT
CTGCAAAACTAGCACAGTT -> TGCAAAACTAGCACAGTTC
CTGCAAAACTATGTACGAA -> TGCAAAACTATGTACGAAG
CTGCAAACTGAATCTACGT -> TGCAAACTGAATCTACGTA
CTGCAATGCCGCTCGGGAA -> TGCAATGCCGCTCGGGAAG
CTGCACCAATATAACTCAT -> TGCACCAATATAACTCATA
CTGCATACTGCATCAAGTA -> TGCATACTGCATCAAGTAC
CTGCATCAAGTACCAGCGT -> TGCATCAAGTACCAGCGTC
CTGCCGCTGACGGTAGATG -> TGCCGCTGACGGTAGATGC
CTGCGTGCACCTCCTTGAT -> TGCGTGCACCTCCTTGATA
CTGCTAGCGACGAAACGAG -> TGCTAGCGACGAAACGAGC
CTGCTCAGGTACGAAGCAG -> TGCTCAGGTACGAAGCAGG
CTGCTGCTGTCGAGCTCTC -> TGCTGCTGTCGAGCTCTCA
CTGCTGTCGAGCTCTCAGT -> TGCTGTCGAGCTCTCAGTG
CTGCTTGCCCCAGTGTATT -> TGCTTGCCCCAGTGTATTA
CTGGAGGTGGGTTGTGGCT -> TGGAGGTGGGTTGTGGCTG
CTGGCCACACTGCAAAACT -> TGGCCACACTGCAAAACTA, TGGCCACACTGCAAAACTA
CTGGCCGCGGCATGTCAAG -> TGGCCGCGGCATGTCAAGT
CTGGCCTGCTAGCGACGAA -> TGGCCTGCTAGCGACGAAA
CTGGGATACCATAAGGGCG -> TGGGATACCATAAGGGCGT
CTGGGGGGCAGCTTACACA -> TGGGGGGCAGCTTACACAA
CTGGGGGTTGTGGAACAGG -> TGGGGGTTGTGGAACAGGC
CTGGGGTGGGTTAACATGG -> TGGGGTGGGTTAACATGGA
CTGGGTCGCAAGATTCTCC -> TGGGTCGCAAGATTCTCCT
CTGGTCATACAGAGCACCA -> TGGTCATACAGAGCACCAG
CTGTAATACAGGAGATGGA -> TGTAATACAGGAGATGGAC
CTGTAATGACACTCGTCAT -> TGTAATGACACTCGTCATG
CTGTAGGGACTAGGGATGC -> TGTAGGGACTAGGGATGCC
CTGTCGAGCTCTCAGTGAA -> TGTCGAGCTCTCAGTGAAG
CTGTCTCTGCTTGCCCCAG -> TGTCTCTGCTTGCCCCAGT
CTGTTCAGGCGCTTGCACG -> TGTTCAGGCGCTTGCACGA
CTGTTGGCAAGACATATCT -> TGTTGGCAAGACATATCTG
CTTAAAATCCTGGGATACC -> TTAAAATCCTGGGATACCA
CTTAAACTACCCCAACGGC -> TTAAACTACCCCAACGGCG
CTTAAGCATGTCGTTAACA -> TTAAGCATGTCGTTAACAA
CTTAAGTGGAATCTGGCCA -> TTAAGTGGAATCTGGCCAC
CTTACACAATTTCTATGAT -> TTACACAATTTCTATGATA
CTTACCCGTCACTGAACTC -> TTACCCGTCACTGAACTCT
CTTACGGTTCCATACTTTC -> TTACGGTTCCATACTTTCA
CTTACTAAACCCAATACTT -> TTACTAAACCCAATACTTG
CTTAGCAATTTGCAAACTG -> TTAGCAATTTGCAAACTGT
CTTATGCACGACGACGGTT -> TTATGCACGACGACGGTTT
CTTCAACTGATCCTCATGG -> TTCAACTGATCCTCATGGT
CTTCAGGCTGTTGGCAAGA -> TTCAGGCTGTTGGCAAGAC
CTTCGTAGCCTTACCCGTC -> TTCGTAGCCTTACCCGTCA
CTTCTTTTTCCCATGGTGC -> TTCTTTTTCCCATGGTGCC
CTTGAAGGCAATAAAGTAA -> TTGAAGGCAATAAAGTAAA
CTTGAAGTACTAAGTTTAA -> TTGAAGTACTAAGTTTAAC
CTTGAGGTGGGATCGGACG -> TTGAGGTGGGATCGGACGG
CTTGATACCAGCCAGAACA -> TTGATACCAGCCAGAACAA
CTTGCACGACCGTTTTGGC -> TTGCACGACCGTTTTGGCG
CTTGCCCCAGTGTATTACA -> TTGCCCCAGTGTATTACAA
CTTGCGCGTTCCCAGGGTG -> TTGCGCGTTCCCAGGGTGA
CTTGGCAGCAGGAATAATA -> TTGGCAGCAGGAATAATAG
CTTGGGTCTATGATAATCG -> TTGGGTCTATGATAATCGG
CTTGTAATTGAGGGTGGTG -> TTGTAATTGAGGGTGGTGT
CTTTCAATGAAACTTAAAA -> TTTCAATGAAACTTAAAAT
CTTTCATCTTATGCACGAC -> TTTCATCTTATGCACGACG
CTTTGAATAGGGATCGACT -> TTTGAATAGGGATCGACTG
CTTTGCATATGAAGCATAA -> TTTGCATATGAAGCATAAG
CTTTTTCCCATGGTGCCGA -> TTTTTCCCATGGTGCCGAT
GAAACGAGCATTGAGAGAG -> AAACGAGCATTGAGAGAGA
GAAACTGCGTGCACCTCCT -> AAACTGCGTGCACCTCCTT
GAAACTTAAAATCCTGGGA -> AAACTTAAAATCCTGGGAT
GAACAAGGGCCGGAGCCTC -> AACAAGGGCCGGAGCCTCT
GAACAGGCGACTAATTATT -> AACAGGCGACTAATTATTT
GAACATAAATATGCCAGCT -> AACATAAATATGCCAGCTT
GAACCCTTGTAATTGAGGG -> AACCCTTGTAATTGAGGGT
GAACGAGCTCCGAGTGAAG -> AACGAGCTCCGAGTGAAGT
GAACGGGTTACTTAAACTA -> AACGGGTTACTTAAACTAC
GAACGGTCCCCGTAAGTCT -> AACGGTCCCCGTAAGTCTT
GAACTCTTGAAGGCAATAA -> AACTCTTGAAGGCAATAAA
GAAGCAGGATCCAAGGCGA -> AAGCAGGATCCAAGGCGAG
GAAGCATAAGCGAGACTCG -> AAGCATAAGCGAGACTCGG
GAAGCTGTCTCTGCTTGCC -> AAGCTGTCTCTGCTTGCCC
GAAGGAGCTGCCGCTGACG -> AAGGAGCTGCCGCTGACGG
GAAGGCAATAAAGTAAACA -> AAGGCAATAAAGTAAACAT
GAAGGCAGTGTATTCGCTG -> AAGGCAGTGTATTCGCTGG
GAAGGCGAGCCTCAACGAT -> AAGGCGAGCCTCAACGATA
GAAGGGAAACTGCGTGCAC -> AAGGGAAACTGCGTGCACC
GAAGTACTAAGTTTAACCC -> AAGTACTAAGTTTAACCCA
GAAGTCTATCCTAACTCGT -> AAGTCTATCCTAACTCGTA
GAAGTGACTTGCGCGTTCC -> AAGTGACTTGCGCGTTCCC
GAATAATAGGTATGTCACA -> AATAATAGGTATGTCACAA
GAATACGCTACAAGGTGGG -> AATACGCTACAAGGTGGGC
GAATAGATCTGGGGGTTGT -> AATAGATCTGGGGGTTGTG
GAATAGGGATCGACTGCTG -> AATAGGGATCGACTGCTGC
GAATCGAGCAGGCGCGGAC -> AATCGAGCAGGCGCGGACC
GAATCTACGTACTAGCACT -> AATCTACGTACTAGCACTT
GAATCTGGCCACACTGCAA -> AATCTGGCCACACTGCAAA
GAATGGGGTTTACAATATA -> AATGGGGTTTACAATATAC
GACAATCGCACTTGGGTCT -> ACAATCGCACTTGGGTCTA
GACACTCGTCATGCGGAAT -> ACACTCGTCATGCGGAATG
GACAGGTCATACGGCATCC -> ACAGGTCATACGGCATCCC
GACATATCTGCACCAATAT -> ACATATCTGCACCAATATA
GACCAACCGGCCTATTTCA -> ACCAACCGGCCTATTTCAA
GACCAGTACGGAGTAACTC -> ACCAGTACGGAGTAACTCC
GACCGAACGGGTTACTTAA -> ACCGAACGGGTTACTTAAA
GACCGTTTTGGCGCGGCCG -> ACCGTTTTGGCGCGGCCGG
GACCTGTTCAGGCGCTTGC -> ACCTGTTCAGGCGCTTGCA
GACGAAACGAGCATTGAGA -> ACGAAACGAGCATTGAGAG
GACGAAGGCGAGCCTCAAC -> ACGAAGGCGAGCCTCAACG
GACGACGGTTTCGCGTGGG -> ACGACGGTTTCGCGTGGGT
GACGCAGTAGAATACGCTA -> ACGCAGTAGAATACGCTAC
GACGGACTTCTTTTTCCCA -> ACGGACTTCTTTTTCCCAT
GACGGGAGGCGACCAACCG -> ACGGGAGGCGACCAACCGG
GACGGGTGACGCAGTAGAA -> ACGGGTGACGCAGTAGAAT
GACGGTAGATGCCAATCGC -> ACGGTAGATGCCAATCGCT
GACGGTTTCGCGTGGGTGC -> ACGGTTTCGCGTGGGTGCG
GACTAATTATTTGCATACC -> ACTAATTATTTGCATACCG
GACTAGGGATGCCTACGGG -> ACTAGGGATGCCTACGGGT
GACTAGTTTATTCGGTGCC -> ACTAGTTTATTCGGTGCCC
GACTCGGGTTACTAGGCCG -> ACTCGGGTTACTAGGCCGC
GACTGCTGCTGTCGAGCTC -> ACTGCTGCTGTCGAGCTCT
GACTTCTTTTTCCCATGGT -> ACTTCTTTTTCCCATGGTG
GACTTGCGCGTTCCCAGGG -> ACTTGCGCGTTCCCAGGGT
GAGAAGGAGCTGCCGCTGA -> AGAAGGAGCTGCCGCTGAC
GAGAATAGATCTGGGGGTT -> AGAATAGATCTGGGGGTTG
GAGACTCGGGTTACTAGGC -> AGACTCGGGTTACTAGGCC
GAGAGAATAGATCTGGGGG -> AGAGAATAGATCTGGGGGT
GAGAGAGAATAGATCTGGG -> AGAGAGAATAGATCTGGGG
GAGAGCATAATGGGCCTCA -> AGAGCATAATGGGCCTCAC
GAGAGCGGGGGTTGTCGGT -> AGAGCGGGGGTTGTCGGTG
GAGATACATCCCCGGGATG -> AGATACATCCCCGGGATGG
GAGATGATCCCTCCTTTGA -> AGATGATCCCTCCTTTGAA
GAGATGCCACACTAATCGT -> AGATGCCACACTAATCGTC
GAGATGGACCGAACGGGTT -> AGATGGACCGAACGGGTTA
GAGATTAACGCTCGCACAT -> AGATTAACGCTCGCACATC
GAGCAACGGTTTGGTAAAC -> AGCAACGGTTTGGTAAACA
GAGCACCAGTTACGATAAC -> AGCACCAGTTACGATAACG
GAGCAGGCGCGGACCAGTA -> AGCAGGCGCGGACCAGTAC
GAGCATAATGGGCCTCACA -> AGCATAATGGGCCTCACAT
GAGCATTGAGAGAGAATAG -> AGCATTGAGAGAGAATAGA
GAGCCATCCAACAGCGGCG -> AGCCATCCAACAGCGGCGC
GAGCCTCAACGATAACGGA -> AGCCTCAACGATAACGGAT
GAGCCTCTGCAATGCCGCT -> AGCCTCTGCAATGCCGCTC
GAGCGGGGGTTGTCGGTGG -> AGCGGGGGTTGTCGGTGGA
GAGCTATCGAGATACATCC -> AGCTATCGAGATACATCCC
GAGCTCCGAGTGAAGTCTA -> AGCTCCGAGTGAAGTCTAT
GAGCTCCTACTTAAGCATG -> AGCTCCTACTTAAGCATGT
GAGCTCTCAGTGAAGGGAA -> AGCTCTCAGTGAAGGGAAA
GAGCTGCCGCTGACGGTAG -> AGCTGCCGCTGACGGTAGA
GAGGCGACCAACCGGCCTA -> AGGCGACCAACCGGCCTAT
GAGGCGTGGGGGCACGGAC -> AGGCGTGGGGGCACGGACG
GAGGGTGGTGTTCTTTCAA -> AGGGTGGTGTTCTTTCAAT
GAGGTGGGATCGGACGGGT -> AGGTGGGATCGGACGGGTG
GAGGTGGGTTGTGGCTGCA -> AGGTGGGTTGTGGCTGCAA
GAGTAACTCCCTAGTTATA -> AGTAACTCCCTAGTTATAC
GAGTATCCTACTGGCCTGC -> AGTATCCTACTGGCCTGCT
GAGTGAAGTCTATCCTAAC -> AGTGAAGTCTATCCTAACT
GAGTTGCGGTCAGGGTGTC -> AGTTGCGGTCAGGGTGTCC
GAGTTTAACCCTGGCCACA -> AGTTTAACCCTGGCCACAC
GATAACACCAATTTGAAGG -> ATAACACCAATTTGAAGGC
GATAACGCTGTAATGACAC -> ATAACGCTGTAATGACACT
GATAACGGATTCATCCCCG -> ATAACGGATTCATCCCCGG
GATAATCGGGACTAGTTTA -> ATAATCGGGACTAGTTTAT
GATACATCCCCGGGATGGT -> ATACATCCCCGGGATGGTC
GATACCAGCCAGAACAAGG -> ATACCAGCCAGAACAAGGG
GATACCATAAGGGCGTAAA -> ATACCATAAGGGCGTAAAA
GATCCAAGGCGAGATTAAC -> ATCCAAGGCGAGATTAACG
GATCCCGGTCCCCTGGAGG -> ATCCCGGTCCCCTGGAGGT
GATCCCTCCTTTGAATAGG -> ATCCCTCCTTTGAATAGGG
GATCCTCATGGTCTATTCG -> ATCCTCATGGTCTATTCGT
GATCGACTGCTGCTGTCGA -> ATCGACTGCTGCTGTCGAG
GATCGGACGGGTGACGCAG -> ATCGGACGGGTGACGCAGT
GATCGTTTCAACCATCCCT -> ATCGTTTCAACCATCCCTG
GATCTCTGAGAGCGGGGGT -> ATCTCTGAGAGCGGGGGTT
GATCTGGGGGTTGTGGAAC -> ATCTGGGGGTTGTGGAACA
GATGATCCCTCCTTTGAAT -> ATGATCCCTCCTTTGAATA
GATGCCAATCGCTGACAGG -> ATGCCAATCGCTGACAGGT
GATGCCACACTAATCGTCG -> ATGCCACACTAATCGTCGT
GATGCCTACGGGTACAAGA -> ATGCCTACGGGTACAAGAA
GATGCGAGCCATCCAACAG -> ATGCGAGCCATCCAACAGC
GATGGACCGAACGGGTTAC -> ATGGACCGAACGGGTTACT
GATGGCAGGTAACTGCTCA -> ATGGCAGGTAACTGCTCAG
GATGGTCCTACCAATACGC -> ATGGTCCTACCAATACGCA
GATGGTCCTCGGCGCCCCG -> ATGGTCCTCGGCGCCCCGT
GATGGTCCTGAGTTTAACC -> ATGGTCCTGAGTTTAACCC
GATGGTCCTTAAGTGGAAT -> ATGGTCCTTAAGTGGAATC
GATGGTTGGATCTCTGAGA -> ATGGTTGGATCTCTGAGAG
GATTAACGCTCGCACATCC -> ATTAACGCTCGCACATCCG
GATTAATCTGCATACTGCA -> ATTAATCTGCATACTGCAT
GATTCATCCCCGGGATGGT -> ATTCATCCCCGGGATGGTC
GATTCTCCTTCGTAGCCTT -> ATTCTCCTTCGTAGCCTTA
GCAAAACTAACGCGGTATC -> CAAAACTAACGCGGTATCG
GCAAAACTAGCACAGTTCA -> CAAAACTAGCACAGTTCAC
GCAAAACTATGTACGAAGT -> CAAAACTATGTACGAAGTG
GCAAACTGAATCTACGTAC -> CAAACTGAATCTACGTACT
GCAAACTGTAATACAGGAG -> CAAACTGTAATACAGGAGA
GCAACCTCACCCACTGTAG -> CAACCTCACCCACTGTAGG
GCAACGGTTTGGTAAACAG -> CAACGGTTTGGTAAACAGC
GCAAGACATATCTGCACCA -> CAAGACATATCTGCACCAA
GCAAGATTCTCCTTCGTAG -> CAAGATTCTCCTTCGTAGC
GCAAGTTTGTTTTAGCGCT -> CAAGTTTGTTTTAGCGCTC
GCAATAAAGTAAACATGTG -> CAATAAAGTAAACATGTGA
GCAATGCCGCTCGGGAAGC -> CAATGCCGCTCGGGAAGCT
GCAATTTGCAAACTGTAAT -> CAATTTGCAAACTGTAATA
GCACACACGTCGGCCATGT -> CACACACGTCGGCCATGTT
GCACAGTTCACAGATCCCG -> CACAGTTCACAGATCCCGG
GCACATCCGGGCCATGTCC -> CACATCCGGGCCATGTCCC
GCACCAATATAACTCATAA -> CACCAATATAACTCATAAT
GCACCAGTTACGATAACGC -> CACCAGTTACGATAACGCT
GCACCTCCTTGATACCAGC -> CACCTCCTTGATACCAGCC
GCACGACCGTTTTGGCGCG -> CACGACCGTTTTGGCGCGG
GCACGACGACGGTTTCGCG -> CACGACGACGGTTTCGCGT
GCACGGACGAAGGCGAGCC -> CACGGACGAAGGCGAGCCT
GCACTTGGGTCTATGATAA -> CACTTGGGTCTATGATAAT
GCACTTTGCATATGAAGCA -> CACTTTGCATATGAAGCAT
GCAGCAGGAATAATAGGTA -> CAGCAGGAATAATAGGTAT
GCAGCTCCCAGTATACGTA -> CAGCTCCCAGTATACGTAA
GCAGCTTACACAATTTCTA -> CAGCTTACACAATTTCTAT
GCAGGAATAATAGGTATGT -> CAGGAATAATAGGTATGTC
GCAGGATCCAAGGCGAGAT -> CAGGATCCAAGGCGAGATT
GCAGGCGCGGACCAGTACG -> CAGGCGCGGACCAGTACGG
GCAGGTAACTGCTCAGGTA -> CAGGTAACTGCTCAGGTAC
GCAGTAAGGCATCTCCCTC -> CAGTAAGGCATCTCCCTCG
GCAGTACACGCTGGGTCGC -> CAGTACACGCTGGGTCGCA
GCAGTAGAATACGCTACAA -> CAGTAGAATACGCTACAAG
GCAGTGTATTCGCTGGTCA -> CAGTGTATTCGCTGGTCAT
GCATAAGCGAGACTCGGGT -> CATAAGCGAGACTCGGGTT
GCATAATGGGCCTCACATG -> CATAATGGGCCTCACATGA
GCATACCGTCTAGTGGCCA -> CATACCGTCTAGTGGCCAC
GCATACTGCATCAAGTACC -> CATACTGCATCAAGTACCA
GCATATGAAGCATAAGCGA -> CATATGAAGCATAAGCGAG
GCATATGGCCTTACGGTTC -> CATATGGCCTTACGGTTCC
GCATCAAGTACCAGCGTCC -> CATCAAGTACCAGCGTCCG
GCATCCCCGGGATGGTCCT -> CATCCCCGGGATGGTCCTG
GCATCGCGCGAGGCGTGGG -> CATCGCGCGAGGCGTGGGG
GCATCTCCCTCGCGCATGG -> CATCTCCCTCGCGCATGGA
GCATGGATCGTTTCAACCA -> CATGGATCGTTTCAACCAT
GCATGGCCACACTGCAAAA -> CATGGCCACACTGCAAAAC
GCATGTCAAGTGATGGCAG -> CATGTCAAGTGATGGCAGG
GCATGTCGTTAACAAAGAG -> CATGTCGTTAACAAAGAGC
GCATTCAAAATGTTATGAG -> CATTCAAAATGTTATGAGA
GCATTGAGAGAGAATAGAT -> CATTGAGAGAGAATAGATC
GCCAATCGCTGACAGGTCA -> CCAATCGCTGACAGGTCAT
GCCACACTAATCGTCGTGG -> CCACACTAATCGTCGTGGA
GCCACACTGCAAAACTAAC -> CCACACTGCAAAACTAACG
GCCACACTGCAAAACTAGC -> CCACACTGCAAAACTAGCA
GCCACACTGCAAAACTATA -> CCACACTGCAAAACTATAC
GCCACACTGCAAAACTATG -> CCACACTGCAAAACTATGT
GCCACAGGCAACCTCACCC -> CCACAGGCAACCTCACCCA
GCCAGAACAAGGGCCGGAG -> CCAGAACAAGGGCCGGAGC
GCCAGCTTCAGGCTGTTGG -> CCAGCTTCAGGCTGTTGGC
GCCAGTAAAACAACAGGCA -> CCAGTAAAACAACAGGCAG
GCCATCCAACAGCGGCGCC -> CCATCCAACAGCGGCGCCT
GCCATGTCCCGCATTCAAA -> CCATGTCCCGCATTCAAAA
GCCATGTTCAATACCAATG -> CCATGTTCAATACCAATGG
GCCCAGAACATAAATATGC -> CCCAGAACATAAATATGCC
GCCCATAATTTGGGCTGGG -> CCCATAATTTGGGCTGGGG
GCCCCAGTGTATTACAATG -> CCCCAGTGTATTACAATGT
GCCCCGTTGGCCACACTGC -> CCCCGTTGGCCACACTGCA
GCCCTTCAACTGATCCTCA -> CCCTTCAACTGATCCTCAT
GCCGATTAATCTGCATACT -> CCGATTAATCTGCATACTG
GCCGCCCATAATTTGGGCT -> CCGCCCATAATTTGGGCTG
GCCGCGGCATGTCAAGTGA -> CCGCGGCATGTCAAGTGAT
GCCGCTCGGGAAGCTGTCT -> CCGCTCGGGAAGCTGTCTC
GCCGCTGACGGTAGATGCC -> CCGCTGACGGTAGATGCCA
GCCGGAGCCTCTGCAATGC -> CCGGAGCCTCTGCAATGCC
GCCGGGCATATGGCCTTAC -> CCGGGCATATGGCCTTACG
GCCTACGGGTACAAGAACG -> CCTACGGGTACAAGAACGG
GCCTATTTCAAACTGGCCG -> CCTATTTCAAACTGGCCGC
GCCTCAACGATAACGGATT -> CCTCAACGATAACGGATTC
GCCTCACATGAGCTCCTAC -> CCTCACATGAGCTCCTACT
GCCTCAGGAACCCTTGTAA -> CCTCAGGAACCCTTGTAAT
GCCTCTGCAATGCCGCTCG -> CCTCTGCAATGCCGCTCGG
GCCTGCTAGCGACGAAACG -> CCTGCTAGCGACGAAACGA
GCCTTACCCGTCACTGAAC -> CCTTACCCGTCACTGAACT
GCCTTACGGTTCCATACTT -> CCTTACGGTTCCATACTTT
GCCTTACTAAACCCAATAC -> CCTTACTAAACCCAATACT
GCCTTGAAGTACTAAGTTT -> CCTTGAAGTACTAAGTTTA
GCGACCAACCGGCCTATTT -> CGACCAACCGGCCTATTTC
GCGACGAAACGAGCATTGA -> CGACGAAACGAGCATTGAG
GCGACTAATTATTTGCATA -> CGACTAATTATTTGCATAC
GCGAGACTCGGGTTACTAG -> CGAGACTCGGGTTACTAGG
GCGAGATTAACGCTCGCAC -> CGAGATTAACGCTCGCACA
GCGAGCCATCCAACAGCGG -> CGAGCCATCCAACAGCGGC
GCGAGCCTCAACGATAACG -> CGAGCCTCAACGATAACGG
GCGAGGCGTGGGGGCACGG -> CGAGGCGTGGGGGCACGGA
GCGCACACACGTCGGCCAT -> CGCACACACGTCGGCCATG
GCGCAGTAAGGCATCTCCC -> CGCAGTAAGGCATCTCCCT
GCGCATGGATCGTTTCAAC -> CGCATGGATCGTTTCAACC
GCGCCCCGTTGGCCACACT -> CGCCCCGTTGGCCACACTG
GCGCCTTACTAAACCCAAT -> CGCCTTACTAAACCCAATA
GCGCGAGGCGTGGGGGCAC -> CGCGAGGCGTGGGGGCACG
GCGCGGACCAGTACGGAGT -> CGCGGACCAGTACGGAGTA
GCGCGGCCGGGCATATGGC -> CGCGGCCGGGCATATGGCC
GCGCGTTCCCAGGGTGACA -> CGCGTTCCCAGGGTGACAA
GCGCTCGTGTGCCCAGAAC -> CGCTCGTGTGCCCAGAACA
GCGCTTGCACGACCGTTTT -> CGCTTGCACGACCGTTTTG
GCGGAATGGGGTTTACAAT -> CGGAATGGGGTTTACAATA
GCGGACCAGTACGGAGTAA -> CGGACCAGTACGGAGTAAC
GCGGCATGTCAAGTGATGG -> CGGCATGTCAAGTGATGGC
GCGGCCGGGCATATGGCCT -> CGGCCGGGCATATGGCCTT
GCGGCGCCTTACTAAACCC -> CGGCGCCTTACTAAACCCA
GCGGGAACGAGCTCCGAGT -> CGGGAACGAGCTCCGAGTG
GCGGGCCTTGAAGTACTAA -> CGGGCCTTGAAGTACTAAG
GCGGGGATGGTTGGATCTC -> CGGGGATGGTTGGATCTCT
GCGGGGGTTGTCGGTGGAT -> CGGGGGTTGTCGGTGGATG
GCGGTATCGTATCCACTGG -> CGGTATCGTATCCACTGGG
GCGGTCAGGGTGTCCCGGT -> CGGTCAGGGTGTCCCGGTT
GCGTAAAACTAGTCAGACC -> CGTAAAACTAGTCAGACCT
GCGTCCGCAAGTTTGTTTT -> CGTCCGCAAGTTTGTTTTA
GCGTGCACCTCCTTGATAC -> CGTGCACCTCCTTGATACC
GCGTGGGGGCACGGACGAA -> CGTGGGGGCACGGACGAAG
GCGTGGGTGCGCACACACG -> CGTGGGTGCGCACACACGT
GCGTTCCCAGGGTGACAAT -> CGTTCCCAGGGTGACAATC
GCTACAAGGTGGGCCTCAG -> CTACAAGGTGGGCCTCAGG
GCTAGCGACGAAACGAGCA -> CTAGCGACGAAACGAGCAT
GCTATCGAGATACATCCCC -> CTATCGAGATACATCCCCG
GCTCAGGTACGAAGCAGGA -> CTCAGGTACGAAGCAGGAT
GCTCCCAGTATACGTAAAC -> CTCCCAGTATACGTAAACG
GCTCCGAGTGAAGTCTATC -> CTCCGAGTGAAGTCTATCC
GCTCCTACTTAAGCATGTC -> CTCCTACTTAAGCATGTCG
GCTCGCACATCCGGGCCAT -> CTCGCACATCCGGGCCATG
GCTCGGGAAGCTGTCTCTG -> CTCGGGAAGCTGTCTCTGC
GCTCGTGTGCCCAGAACAT -> CTCGTGTGCCCAGAACATA
GCTCTCAGTGAAGGGAAAC -> CTCTCAGTGAAGGGAAACT
GCTGACAGGTCATACGGCA -> CTGACAGGTCATACGGCAT
GCTGACGGTAGATGCCAAT -> CTGACGGTAGATGCCAATC
GCTGCAAACTGAATCTACG -> CTGCAAACTGAATCTACGT
GCTGCCGCTGACGGTAGAT -> CTGCCGCTGACGGTAGATG
GCTGCTGTCGAGCTCTCAG -> CTGCTGTCGAGCTCTCAGT
GCTGGGGTGGGTTAACATG -> CTGGGGTGGGTTAACATGG
GCTGGGTCGCAAGATTCTC -> CTGGGTCGCAAGATTCTCC
GCTGGTCATACAGAGCACC -> CTGGTCATACAGAGCACCA
GCTGTAATGACACTCGTCA -> CTGTAATGACACTCGTCAT
GCTGTCGAGCTCTCAGTGA -> CTGTCGAGCTCTCAGTGAA
GCTGTCTCTGCTTGCCCCA -> CTGTCTCTGCTTGCCCCAG
GCTGTTGGCAAGACATATC -> CTGTTGGCAAGACATATCT
GCTTACACAATTTCTATGA -> CTTACACAATTTCTATGAT
GCTTCAGGCTGTTGGCAAG -> CTTCAGGCTGTTGGCAAGA
GCTTGCACGACCGTTTTGG -> CTTGCACGACCGTTTTGGC
GCTTGCCCCAGTGTATTAC -> CTTGCCCCAGTGTATTACA
GCTTGGCAGCAGGAATAAT -> CTTGGCAGCAGGAATAATA
GGAAACTGCGTGCACCTCC -> GAAACTGCGTGCACCTCCT
GGAACAGGCGACTAATTAT -> GAACAGGCGACTAATTATT
GGAACCCTTGTAATTGAGG -> GAACCCTTGTAATTGAGGG
GGAACGAGCTCCGAGTGAA -> GAACGAGCTCCGAGTGAAG
GGAAGCTGTCTCTGCTTGC -> GAAGCTGTCTCTGCTTGCC
GGAATAATAGGTATGTCAC -> GAATAATAGGTATGTCACA
GGAATCTGGCCACACTGCA -> GAATCTGGCCACACTGCAA
GGAATGGGGTTTACAATAT -> GAATGGGGTTTACAATATA
GGACCAGTACGGAGTAACT -> GACCAGTACGGAGTAACTC
GGACCGAACGGGTTACTTA -> GACCGAACGGGTTACTTAA
GGACGAAGGCGAGCCTCAA -> GACGAAGGCGAGCCTCAAC
GGACGGGAGGCGACCAACC -> GACGGGAGGCGACCAACCG
GGACGGGTGACGCAGTAGA -> GACGGGTGACGCAGTAGAA
GGACTAGGGATGCCTACGG -> GACTAGGGATGCCTACGGG
GGACTAGTTTATTCGGTGC -> GACTAGTTTATTCGGTGCC
GGACTTCTTTTTCCCATGG -> GACTTCTTTTTCCCATGGT
GGAGATGATCCCTCCTTTG -> GAGATGATCCCTCCTTTGA
GGAGATGGACCGAACGGGT -> GAGATGGACCGAACGGGTT
GGAGCCTCTGCAATGCCGC -> GAGCCTCTGCAATGCCGCT
GGAGCTGCCGCTGACGGTA -> GAGCTGCCGCTGACGGTAG
GGAGGCGACCAACCGGCCT -> GAGGCGACCAACCGGCCTA
GGAGGTGGGTTGTGGCTGC -> GAGGTGGGTTGTGGCTGCA
GGAGTAACTCCCTAGTTAT -> GAGTAACTCCCTAGTTATA
GGAGTTGCGGTCAGGGTGT -> GAGTTGCGGTCAGGGTGTC
GGATACCATAAGGGCGTAA -> GATACCATAAGGGCGTAAA
GGATCCAAGGCGAGATTAA -> GATCCAAGGCGAGATTAAC
GGATCGACTGCTGCTGTCG -> GATCGACTGCTGCTGTCGA
GGATCGGACGGGTGACGCA -> GATCGGACGGGTGACGCAG
GGATCGTTTCAACCATCCC -> GATCGTTTCAACCATCCCT
GGATCTCTGAGAGCGGGGG -> GATCTCTGAGAGCGGGGGT
GGATGCCTACGGGTACAAG -> GATGCCTACGGGTACAAGA
GGATGCGAGCCATCCAACA -> GATGCGAGCCATCCAACAG
GGATGGTCCTACCAATACG -> GATGGTCCTACCAATACGC
GGATGGTCCTCGGCGCCCC -> GATGGTCCTCGGCGCCCCG
GGATGGTCCTGAGTTTAAC -> GATGGTCCTGAGTTTAACC
GGATGGTCCTTAAGTGGAA -> GATGGTCCTTAAGTGGAAT
GGATGGTTGGATCTCTGAG -> GATGGTTGGATCTCTGAGA
GGATTCATCCCCGGGATGG -> GATTCATCCCCGGGATGGT
GGCAACCTCACCCACTGTA -> GCAACCTCACCCACTGTAG
GGCAAGACATATCTGCACC -> GCAAGACATATCTGCACCA
GGCAATAAAGTAAACATGT -> GCAATAAAGTAAACATGTG
GGCACGGACGAAGGCGAGC -> GCACGGACGAAGGCGAGCC
GGCAGCAGGAATAATAGGT -> GCAGCAGGAATAATAGGTA
GGCAGCTCCCAGTATACGT -> GCAGCTCCCAGTATACGTA
GGCAGCTTACACAATTTCT -> GCAGCTTACACAATTTCTA
GGCAGGTAACTGCTCAGGT -> GCAGGTAACTGCTCAGGTA
GGCAGTGTATTCGCTGGTC -> GCAGTGTATTCGCTGGTCA
GGCATATGGCCTTACGGTT -> GCATATGGCCTTACGGTTC
GGCATCCCCGGGATGGTCC -> GCATCCCCGGGATGGTCCT
GGCATCGCGCGAGGCGTGG -> GCATCGCGCGAGGCGTGGG
GGCATCTCCCTCGCGCATG -> GCATCTCCCTCGCGCATGG
GGCATGTCAAGTGATGGCA -> GCATGTCAAGTGATGGCAG
GGCCACACTGCAAAACTAA -> GCCACACTGCAAAACTAAC
GGCCACACTGCAAAACTAG -> GCCACACTGCAAAACTAGC
GGCCACACTGCAAAACTAT -> GCCACACTGCAAAACTATG, GCCACACTGCAAAACTATA
GGCCACAGGCAACCTCACC -> GCCACAGGCAACCTCACCC
GGCCATGTCCCGCATTCAA -> GCCATGTCCCGCATTCAAA
GGCCATGTTCAATACCAAT -> GCCATGTTCAATACCAATG
GGCCGCCCATAATTTGGGC -> GCCGCCCATAATTTGGGCT
GGCCGCGGCATGTCAAGTG -> GCCGCGGCATGTCAAGTGA
GGCCGGAGCCTCTGCAATG -> GCCGGAGCCTCTGCAATGC
GGCCGGGCATATGGCCTTA -> GCCGGGCATATGGCCTTAC
GGCCTATTTCAAACTGGCC -> GCCTATTTCAAACTGGCCG
GGCCTCACATGAGCTCCTA -> GCCTCACATGAGCTCCTAC
GGCCTCAGGAACCCTTGTA -> GCCTCAGGAACCCTTGTAA
GGCCTGCTAGCGACGAAAC -> GCCTGCTAGCGACGAAACG
GGCCTTACGGTTCCATACT -> GCCTTACGGTTCCATACTT
GGCCTTGAAGTACTAAGTT -> GCCTTGAAGTACTAAGTTT
GGCGACCAACCGGCCTATT -> GCGACCAACCGGCCTATTT
GGCGACTAATTATTTGCAT -> GCGACTAATTATTTGCATA
GGCGAGATTAACGCTCGCA -> GCGAGATTAACGCTCGCAC
GGCGAGCCTCAACGATAAC -> GCGAGCCTCAACGATAACG
GGCGCCCCGTTGGCCACAC -> GCGCCCCGTTGGCCACACT
GGCGCCTTACTAAACCCAA -> GCGCCTTACTAAACCCAAT
GGCGCGGACCAGTACGGAG -> GCGCGGACCAGTACGGAGT
GGCGCGGCCGGGCATATGG -> GCGCGGCCGGGCATATGGC
GGCGCTTGCACGACCGTTT -> GCGCTTGCACGACCGTTTT
GGCGGGAACGAGCTCCGAG -> GCGGGAACGAGCTCCGAGT
GGCGTAAAACTAGTCAGAC -> GCGTAAAACTAGTCAGACC
GGCGTGGGGGCACGGACGA -> GCGTGGGGGCACGGACGAA
GGCTGCAAACTGAATCTAC -> GCTGCAAACTGAATCTACG
GGCTGGGGTGGGTTAACAT -> GCTGGGGTGGGTTAACATG
GGCTGTTGGCAAGACATAT -> GCTGTTGGCAAGACATATC
GGCTTGGCAGCAGGAATAA -> GCTTGGCAGCAGGAATAAT
GGGAAACTGCGTGCACCTC -> GGAAACTGCGTGCACCTCC
GGGAACGAGCTCCGAGTGA -> GGAACGAGCTCCGAGTGAA
GGGAAGCTGTCTCTGCTTG -> GGAAGCTGTCTCTGCTTGC
GGGACTAGGGATGCCTACG -> GGACTAGGGATGCCTACGG
GGGACTAGTTTATTCGGTG -> GGACTAGTTTATTCGGTGC
GGGAGGCGACCAACCGGCC -> GGAGGCGACCAACCGGCCT
GGGAGTTGCGGTCAGGGTG -> GGAGTTGCGGTCAGGGTGT
GGGATACCATAAGGGCGTA -> GGATACCATAAGGGCGTAA
GGGATCGACTGCTGCTGTC -> GGATCGACTGCTGCTGTCG
GGGATCGGACGGGTGACGC -> GGATCGGACGGGTGACGCA
GGGATGCCTACGGGTACAA -> GGATGCCTACGGGTACAAG
GGGATGGTCCTACCAATAC -> GGATGGTCCTACCAATACG
GGGATGGTCCTCGGCGCCC -> GGATGGTCCTCGGCGCCCC
GGGATGGTCCTGAGTTTAA -> GGATGGTCCTGAGTTTAAC
GGGATGGTCCTTAAGTGGA -> GGATGGTCCTTAAGTGGAA
GGGATGGTTGGATCTCTGA -> GGATGGTTGGATCTCTGAG
GGGCACGGACGAAGGCGAG -> GGCACGGACGAAGGCGAGC
GGGCAGCTTACACAATTTC -> GGCAGCTTACACAATTTCT
GGGCATATGGCCTTACGGT -> GGCATATGGCCTTACGGTT
GGGCCATGTCCCGCATTCA -> GGCCATGTCCCGCATTCAA
GGGCCGGAGCCTCTGCAAT -> GGCCGGAGCCTCTGCAATG
GGGCCTCACATGAGCTCCT -> GGCCTCACATGAGCTCCTA
GGGCCTCAGGAACCCTTGT -> GGCCTCAGGAACCCTTGTA
GGGCCTTGAAGTACTAAGT -> GGCCTTGAAGTACTAAGTT
GGGCGTAAAACTAGTCAGA -> GGCGTAAAACTAGTCAGAC
GGGCTGGGGTGGGTTAACA -> GGCTGGGGTGGGTTAACAT
GGGCTTGGCAGCAGGAATA -> GGCTTGGCAGCAGGAATAA
GGGGATGGTTGGATCTCTG -> GGGATGGTTGGATCTCTGA
GGGGCACGGACGAAGGCGA -> GGGCACGGACGAAGGCGAG
GGGGCAGCTTACACAATTT -> GGGCAGCTTACACAATTTC
GGGGGCACGGACGAAGGCG -> GGGGCACGGACGAAGGCGA
GGGGGCAGCTTACACAATT -> GGGGCAGCTTACACAATTT
GGGGGGCAGCTTACACAAT -> GGGGGCAGCTTACACAATT
GGGGGTTGTCGGTGGATGC -> GGGGTTGTCGGTGGATGCG
GGGGGTTGTGGAACAGGCG -> GGGGTTGTGGAACAGGCGA
GGGGTGGGTTAACATGGAC -> GGGTGGGTTAACATGGACG
GGGGTTGTCGGTGGATGCG -> GGGTTGTCGGTGGATGCGA
GGGGTTGTGGAACAGGCGA -> GGGTTGTGGAACAGGCGAC
GGGGTTTACAATATACCAT -> GGGTTTACAATATACCATT
GGGTACAAGAACGGTCCCC -> GGTACAAGAACGGTCCCCG
GGGTCGCAAGATTCTCCTT -> GGTCGCAAGATTCTCCTTC
GGGTCTATGATAATCGGGA -> GGTCTATGATAATCGGGAC
GGGTGACAATCGCACTTGG -> GGTGACAATCGCACTTGGG
GGGTGACGCAGTAGAATAC -> GGTGACGCAGTAGAATACG
GGGTGCGCACACACGTCGG -> GGTGCGCACACACGTCGGC
GGGTGGGTTAACATGGACG -> GGTGGGTTAACATGGACGG
GGGTGGTGTTCTTTCAATG -> GGTGGTGTTCTTTCAATGA
GGGTGTCCCGGTTTTTTGA -> GGTGTCCCGGTTTTTTGAA
GGGTTAACATGGACGGGAG -> GGTTAACATGGACGGGAGG
GGGTTACTAGGCCGCCCAT -> GGTTACTAGGCCGCCCATA
GGGTTACTTAAACTACCCC -> GGTTACTTAAACTACCCCA
GGGTTGTCGGTGGATGCGA -> GGTTGTCGGTGGATGCGAG
GGGTTGTGGAACAGGCGAC -> GGTTGTGGAACAGGCGACT
GGGTTGTGGCTGCAAACTG -> GGTTGTGGCTGCAAACTGA
GGGTTTACAATATACCATT -> GGTTTACAATATACCATTG
GGTAAACAGCGGGCCTTGA -> GTAAACAGCGGGCCTTGAA
GGTAACTGCTCAGGTACGA -> GTAACTGCTCAGGTACGAA
GGTACAAGAACGGTCCCCG -> GTACAAGAACGGTCCCCGT
GGTACGAAGCAGGATCCAA -> GTACGAAGCAGGATCCAAG
GGTAGATGCCAATCGCTGA -> GTAGATGCCAATCGCTGAC
GGTATCGTATCCACTGGGG -> GTATCGTATCCACTGGGGG
GGTATGTCACAATCGCCAG -> GTATGTCACAATCGCCAGT
GGTCAGGGTGTCCCGGTTT -> GTCAGGGTGTCCCGGTTTT
GGTCATACAGAGCACCAGT -> GTCATACAGAGCACCAGTT
GGTCATACGGCATCCCCGG -> GTCATACGGCATCCCCGGG
GGTCCCCGTAAGTCTTAGC -> GTCCCCGTAAGTCTTAGCA
GGTCCCCTGGAGGTGGGTT -> GTCCCCTGGAGGTGGGTTG
GGTCCTACCAATACGCATG -> GTCCTACCAATACGCATGG
GGTCCTCGGCGCCCCGTTG -> GTCCTCGGCGCCCCGTTGG
GGTCCTGAGTTTAACCCTG -> GTCCTGAGTTTAACCCTGG
GGTCCTTAAGTGGAATCTG -> GTCCTTAAGTGGAATCTGG
GGTCGCAAGATTCTCCTTC -> GTCGCAAGATTCTCCTTCG
GGTCTATGATAATCGGGAC -> GTCTATGATAATCGGGACT
GGTCTATTCGTGGGAGTTG -> GTCTATTCGTGGGAGTTGC
GGTGACAATCGCACTTGGG -> GTGACAATCGCACTTGGGT
GGTGACGCAGTAGAATACG -> GTGACGCAGTAGAATACGC
GGTGCCCTTCAACTGATCC -> GTGCCCTTCAACTGATCCT
GGTGCCGATTAATCTGCAT -> GTGCCGATTAATCTGCATA
GGTGCGCACACACGTCGGC -> GTGCGCACACACGTCGGCC
GGTGGATGCGAGCCATCCA -> GTGGATGCGAGCCATCCAA
GGTGGGATCGGACGGGTGA -> GTGGGATCGGACGGGTGAC
GGTGGGCCTCAGGAACCCT -> GTGGGCCTCAGGAACCCTT
GGTGGGTTAACATGGACGG -> GTGGGTTAACATGGACGGG
GGTGGGTTGTGGCTGCAAA -> GTGGGTTGTGGCTGCAAAC
GGTGGTGTTCTTTCAATGA -> GTGGTGTTCTTTCAATGAA
GGTGTCCCGGTTTTTTGAA -> GTGTCCCGGTTTTTTGAAT
GGTGTTCTTTCAATGAAAC -> GTGTTCTTTCAATGAAACT
GGTTAACATGGACGGGAGG -> GTTAACATGGACGGGAGGC
GGTTACTAGGCCGCCCATA -> GTTACTAGGCCGCCCATAA
GGTTACTTAAACTACCCCA -> GTTACTTAAACTACCCCAA
GGTTCCATACTTTCATCTT -> GTTCCATACTTTCATCTTA
GGTTGGATCTCTGAGAGCG -> GTTGGATCTCTGAGAGCGG
GGTTGTCGGTGGATGCGAG -> GTTGTCGGTGGATGCGAGC
GGTTGTGGAACAGGCGACT -> GTTGTGGAACAGGCGACTA
GGTTGTGGCTGCAAACTGA -> GTTGTGGCTGCAAACTGAA
GGTTTACAATATACCATTG -> GTTTACAATATACCATTGA
GGTTTCGCGTGGGTGCGCA -> GTTTCGCGTGGGTGCGCAC
GGTTTGGTAAACAGCGGGC -> GTTTGGTAAACAGCGGGCC
GGTTTTTTGAATCGAGCAG -> GTTTTTTGAATCGAGCAGG
GTAAAACAACAGGCAGCTC -> TAAAACAACAGGCAGCTCC
GTAAAACTAGTCAGACCTG -> TAAAACTAGTCAGACCTGT
GTAAACAGCGGGCCTTGAA -> TAAACAGCGGGCCTTGAAG
GTAAACATGTGACGGACTT -> TAAACATGTGACGGACTTC
GTAAACGAGATGCCACACT -> TAAACGAGATGCCACACTA
GTAACTCCCTAGTTATACC -> TAACTCCCTAGTTATACCG
GTAACTGCTCAGGTACGAA -> TAACTGCTCAGGTACGAAG
GTAAGGCATCGCGCGAGGC -> TAAGGCATCGCGCGAGGCG
GTAAGGCATCTCCCTCGCG -> TAAGGCATCTCCCTCGCGC
GTAAGTCTTAGCAATTTGC -> TAAGTCTTAGCAATTTGCA
GTAATACAGGAGATGGACC -> TAATACAGGAGATGGACCG
GTAATGACACTCGTCATGC -> TAATGACACTCGTCATGCG
GTAATTGAGGGTGGTGTTC -> TAATTGAGGGTGGTGTTCT
GTACAAGAACGGTCCCCGT -> TACAAGAACGGTCCCCGTA
GTACACGCTGGGTCGCAAG -> TACACGCTGGGTCGCAAGA
GTACCAGCGTCCGCAAGTT -> TACCAGCGTCCGCAAGTTT
GTACGAAGCAGGATCCAAG -> TACGAAGCAGGATCCAAGG
GTACGAAGTGACTTGCGCG -> TACGAAGTGACTTGCGCGT
GTACGGAGTAACTCCCTAG -> TACGGAGTAACTCCCTAGT
GTACTAAGTTTAACCCAGC -> TACTAAGTTTAACCCAGCG
GTACTAGCACTTTGCATAT -> TACTAGCACTTTGCATATG
GTAGAATACGCTACAAGGT -> TAGAATACGCTACAAGGTG
GTAGATGCCAATCGCTGAC -> TAGATGCCAATCGCTGACA
GTAGCCTTACCCGTCACTG -> TAGCCTTACCCGTCACTGA
GTAGGGACTAGGGATGCCT -> TAGGGACTAGGGATGCCTA
GTATACGTAAACGAGATGC -> TATACGTAAACGAGATGCC
GTATCCACTGGGGGGCAGC -> TATCCACTGGGGGGCAGCT
GTATCCTACTGGCCTGCTA -> TATCCTACTGGCCTGCTAG
GTATCGTATCCACTGGGGG -> TATCGTATCCACTGGGGGG
GTATGTCACAATCGCCAGT -> TATGTCACAATCGCCAGTA
GTATTACAATGTCCATCCC -> TATTACAATGTCCATCCCC
GTATTCGCTGGTCATACAG -> TATTCGCTGGTCATACAGA
GTCAAGTGATGGCAGGTAA -> TCAAGTGATGGCAGGTAAC
GTCACAATCGCCAGTAAAA -> TCACAATCGCCAGTAAAAC
GTCACTGAACTCTTGAAGG -> TCACTGAACTCTTGAAGGC
GTCAGACCTGTTCAGGCGC -> TCAGACCTGTTCAGGCGCT
GTCAGGGTGTCCCGGTTTT -> TCAGGGTGTCCCGGTTTTT
GTCATACAGAGCACCAGTT -> TCATACAGAGCACCAGTTA
GTCATACGGCATCCCCGGG -> TCATACGGCATCCCCGGGA
GTCATGCGGAATGGGGTTT -> TCATGCGGAATGGGGTTTA
GTCCATCCCCGGGATGGTC -> TCCATCCCCGGGATGGTCC
GTCCCCGTAAGTCTTAGCA -> TCCCCGTAAGTCTTAGCAA
GTCCCCTGGAGGTGGGTTG -> TCCCCTGGAGGTGGGTTGT
GTCCCGCATTCAAAATGTT -> TCCCGCATTCAAAATGTTA
GTCCCGGTTTTTTGAATCG -> TCCCGGTTTTTTGAATCGA
GTCCGCAAGTTTGTTTTAG -> TCCGCAAGTTTGTTTTAGC
GTCCTACCAATACGCATGG -> TCCTACCAATACGCATGGC
GTCCTCGGCGCCCCGTTGG -> TCCTCGGCGCCCCGTTGGC
GTCCTGAGTTTAACCCTGG -> TCCTGAGTTTAACCCTGGC
GTCCTTAAGTGGAATCTGG -> TCCTTAAGTGGAATCTGGC
GTCGAGCTCTCAGTGAAGG -> TCGAGCTCTCAGTGAAGGG
GTCGCAAGATTCTCCTTCG -> TCGCAAGATTCTCCTTCGT
GTCGGCCATGTTCAATACC -> TCGGCCATGTTCAATACCA
GTCGGTGGATGCGAGCCAT -> TCGGTGGATGCGAGCCATC
GTCGTGGAGATGATCCCTC -> TCGTGGAGATGATCCCTCC
GTCGTTAACAAAGAGCTAT -> TCGTTAACAAAGAGCTATC
GTCTAGTGGCCACAGGCAA -> TCTAGTGGCCACAGGCAAC
GTCTATCCTAACTCGTAAG -> TCTATCCTAACTCGTAAGG
GTCTATGATAATCGGGACT -> TCTATGATAATCGGGACTA
GTCTATTCGTGGGAGTTGC -> TCTATTCGTGGGAGTTGCG
GTCTCTGCTTGCCCCAGTG -> TCTCTGCTTGCCCCAGTGT
GTCTTAGCAATTTGCAAAC -> TCTTAGCAATTTGCAAACT
GTGAAGGGAAACTGCGTGC -> TGAAGGGAAACTGCGTGCA
GTGAAGTCTATCCTAACTC -> TGAAGTCTATCCTAACTCG
GTGACAATCGCACTTGGGT -> TGACAATCGCACTTGGGTC
GTGACGCAGTAGAATACGC -> TGACGCAGTAGAATACGCT
GTGACGGACTTCTTTTTCC -> TGACGGACTTCTTTTTCCC
GTGACTTGCGCGTTCCCAG -> TGACTTGCGCGTTCCCAGG
GTGATGGCAGGTAACTGCT -> TGATGGCAGGTAACTGCTC
GTGCACCTCCTTGATACCA -> TGCACCTCCTTGATACCAG
GTGCCCAGAACATAAATAT -> TGCCCAGAACATAAATATG
GTGCCCTTCAACTGATCCT -> TGCCCTTCAACTGATCCTC
GTGCCGATTAATCTGCATA -> TGCCGATTAATCTGCATAC
GTGCGCACACACGTCGGCC -> TGCGCACACACGTCGGCCA
GTGGAACAGGCGACTAATT -> TGGAACAGGCGACTAATTA
GTGGAATCTGGCCACACTG -> TGGAATCTGGCCACACTGC
GTGGAGATGATCCCTCCTT -> TGGAGATGATCCCTCCTTT
GTGGATGCGAGCCATCCAA -> TGGATGCGAGCCATCCAAC
GTGGCCACAGGCAACCTCA -> TGGCCACAGGCAACCTCAC
GTGGCTGCAAACTGAATCT -> TGGCTGCAAACTGAATCTA
GTGGGAGTTGCGGTCAGGG -> TGGGAGTTGCGGTCAGGGT
GTGGGATCGGACGGGTGAC -> TGGGATCGGACGGGTGACG
GTGGGCCTCAGGAACCCTT -> TGGGCCTCAGGAACCCTTG
GTGGGGGCACGGACGAAGG -> TGGGGGCACGGACGAAGGC
GTGGGTGCGCACACACGTC -> TGGGTGCGCACACACGTCG
GTGGGTTAACATGGACGGG -> TGGGTTAACATGGACGGGA
GTGGGTTGTGGCTGCAAAC -> TGGGTTGTGGCTGCAAACT
GTGGTGTTCTTTCAATGAA -> TGGTGTTCTTTCAATGAAA
GTGTATTACAATGTCCATC -> TGTATTACAATGTCCATCC
GTGTATTCGCTGGTCATAC -> TGTATTCGCTGGTCATACA
GTGTCCCGGTTTTTTGAAT -> TGTCCCGGTTTTTTGAATC
GTGTGCCCAGAACATAAAT -> TGTGCCCAGAACATAAATA
GTGTTCTTTCAATGAAACT -> TGTTCTTTCAATGAAACTT
GTTAACAAAGAGCTATCGA -> TTAACAAAGAGCTATCGAG
GTTAACATGGACGGGAGGC -> TTAACATGGACGGGAGGCG
GTTACGATAACGCTGTAAT -> TTACGATAACGCTGTAATG
GTTACTAGGCCGCCCATAA -> TTACTAGGCCGCCCATAAT
GTTACTTAAACTACCCCAA -> TTACTTAAACTACCCCAAC
GTTATACCGCGCAGTAAGG -> TTATACCGCGCAGTAAGGC
GTTATGAGAAGGAGCTGCC -> TTATGAGAAGGAGCTGCCG
GTTCAATACCAATGGGCTT -> TTCAATACCAATGGGCTTG
GTTCACAGATCCCGGTCCC -> TTCACAGATCCCGGTCCCC
GTTCAGGCGCTTGCACGAC -> TTCAGGCGCTTGCACGACC
GTTCCATACTTTCATCTTA -> TTCCATACTTTCATCTTAT
GTTCCCAGGGTGACAATCG -> TTCCCAGGGTGACAATCGC
GTTCTTTCAATGAAACTTA -> TTCTTTCAATGAAACTTAA
GTTGCGGTCAGGGTGTCCC -> TTGCGGTCAGGGTGTCCCG
GTTGGATCTCTGAGAGCGG -> TTGGATCTCTGAGAGCGGG
GTTGGCAAGACATATCTGC -> TTGGCAAGACATATCTGCA
GTTGGCCACACTGCAAAAC -> TTGGCCACACTGCAAAACT
GTTGTCGGTGGATGCGAGC -> TTGTCGGTGGATGCGAGCC
GTTGTGGAACAGGCGACTA -> TTGTGGAACAGGCGACTAA
GTTGTGGCTGCAAACTGAA -> TTGTGGCTGCAAACTGAAT
GTTTAACCCAGCGGGGATG -> TTTAACCCAGCGGGGATGG
GTTTAACCCTGGCCACACT -> TTTAACCCTGGCCACACTG
GTTTACAATATACCATTGA -> TTTACAATATACCATTGAG
GTTTATTCGGTGCCCTTCA -> TTTATTCGGTGCCCTTCAA
GTTTCAACCATCCCTGAGC -> TTTCAACCATCCCTGAGCA
GTTTCGCGTGGGTGCGCAC -> TTTCGCGTGGGTGCGCACA
GTTTGGTAAACAGCGGGCC -> TTTGGTAAACAGCGGGCCT
GTTTGTTTTAGCGCTCGTG -> TTTGTTTTAGCGCTCGTGT
GTTTTAGCGCTCGTGTGCC -> TTTTAGCGCTCGTGTGCCC
GTTTTGGCGCGGCCGGGCA -> TTTTGGCGCGGCCGGGCAT
GTTTTTTGAATCGAGCAGG -> TTTTTTGAATCGAGCAGGC
TAAAACAACAGGCAGCTCC -> AAAACAACAGGCAGCTCCC
TAAAACTAGTCAGACCTGT -> AAAACTAGTCAGACCTGTT
TAAAATCCTGGGATACCAT -> AAAATCCTGGGATACCATA
TAAACAGCGGGCCTTGAAG -> AAACAGCGGGCCTTGAAGT
TAAACATGTGACGGACTTC -> AAACATGTGACGGACTTCT
TAAACCCAATACTTGAGGT -> AAACCCAATACTTGAGGTG
TAAACGAGATGCCACACTA -> AAACGAGATGCCACACTAA
TAAACTACCCCAACGGCGG -> AAACTACCCCAACGGCGGG
TAAAGTAAACATGTGACGG -> AAAGTAAACATGTGACGGA
TAAATATGCCAGCTTCAGG -> AAATATGCCAGCTTCAGGC
TAACAAAGAGCTATCGAGA -> AACAAAGAGCTATCGAGAT
TAACACCAATTTGAAGGCA -> AACACCAATTTGAAGGCAG
TAACATGGACGGGAGGCGA -> AACATGGACGGGAGGCGAC
TAACCCAGCGGGGATGGTT -> AACCCAGCGGGGATGGTTG
TAACCCTGGCCACACTGCA -> AACCCTGGCCACACTGCAA
TAACGCGGTATCGTATCCA -> AACGCGGTATCGTATCCAC
TAACGCTCGCACATCCGGG -> AACGCTCGCACATCCGGGC
TAACGCTGTAATGACACTC -> AACGCTGTAATGACACTCG
TAACGGATTCATCCCCGGG -> AACGGATTCATCCCCGGGA
TAACTCATAATCATGAGTA -> AACTCATAATCATGAGTAT
TAACTCCCTAGTTATACCG -> AACTCCCTAGTTATACCGC
TAACTCGTAAGGCATCGCG -> AACTCGTAAGGCATCGCGC
TAACTGCTCAGGTACGAAG -> AACTGCTCAGGTACGAAGC
TAAGCATGTCGTTAACAAA -> AAGCATGTCGTTAACAAAG
TAAGCGAGACTCGGGTTAC -> AAGCGAGACTCGGGTTACT
TAAGGCATCGCGCGAGGCG -> AAGGCATCGCGCGAGGCGT
TAAGGCATCTCCCTCGCGC -> AAGGCATCTCCCTCGCGCA
TAAGGGCGTAAAACTAGTC -> AAGGGCGTAAAACTAGTCA
TAAGTCTTAGCAATTTGCA -> AAGTCTTAGCAATTTGCAA
TAAGTGGAATCTGGCCACA -> AAGTGGAATCTGGCCACAC
TAAGTTTAACCCAGCGGGG -> AAGTTTAACCCAGCGGGGA
TAATACAGGAGATGGACCG -> AATACAGGAGATGGACCGA
TAATAGGTATGTCACAATC -> AATAGGTATGTCACAATCG
TAATCATGAGTATCCTACT -> AATCATGAGTATCCTACTG
TAATCGGGACTAGTTTATT -> AATCGGGACTAGTTTATTC
TAATCGTCGTGGAGATGAT -> AATCGTCGTGGAGATGATC
TAATCTGCATACTGCATCA -> AATCTGCATACTGCATCAA
TAATGACACTCGTCATGCG -> AATGACACTCGTCATGCGG
TAATGGGCCTCACATGAGC -> AATGGGCCTCACATGAGCT
TAATTATTTGCATACCGTC -> AATTATTTGCATACCGTCT
TAATTGAGGGTGGTGTTCT -> AATTGAGGGTGGTGTTCTT
TAATTTGGGCTGGGGTGGG -> AATTTGGGCTGGGGTGGGT
TACAAGAACGGTCCCCGTA -> ACAAGAACGGTCCCCGTAA
TACAAGGTGGGCCTCAGGA -> ACAAGGTGGGCCTCAGGAA
TACAATATACCATTGAGAG -> ACAATATACCATTGAGAGC
TACAATGTCCATCCCCGGG -> ACAATGTCCATCCCCGGGA
TACACAATTTCTATGATAA -> ACACAATTTCTATGATAAC
TACACGCTGGGTCGCAAGA -> ACACGCTGGGTCGCAAGAT
TACAGAGCACCAGTTACGA -> ACAGAGCACCAGTTACGAT
TACAGGAGATGGACCGAAC -> ACAGGAGATGGACCGAACG
TACATCCCCGGGATGGTCC -> ACATCCCCGGGATGGTCCT
TACCAATACGCATGGCCAC -> ACCAATACGCATGGCCACA
TACCAATGGGCTTGGCAGC -> ACCAATGGGCTTGGCAGCA
TACCAGCCAGAACAAGGGC -> ACCAGCCAGAACAAGGGCC
TACCAGCGTCCGCAAGTTT -> ACCAGCGTCCGCAAGTTTG
TACCATAAGGGCGTAAAAC -> ACCATAAGGGCGTAAAACT
TACCATTGAGAGCATAATG -> ACCATTGAGAGCATAATGG
TACCCCAACGGCGGGAACG -> ACCCCAACGGCGGGAACGA
TACCCGTCACTGAACTCTT -> ACCCGTCACTGAACTCTTG
TACCGCGCAGTAAGGCATC -> ACCGCGCAGTAAGGCATCT
TACCGTCTAGTGGCCACAG -> ACCGTCTAGTGGCCACAGG
TACGAAGCAGGATCCAAGG -> ACGAAGCAGGATCCAAGGC
TACGAAGTGACTTGCGCGT -> ACGAAGTGACTTGCGCGTT
TACGATAACGCTGTAATGA -> ACGATAACGCTGTAATGAC
TACGCATGGCCACACTGCA -> ACGCATGGCCACACTGCAA
TACGCTACAAGGTGGGCCT -> ACGCTACAAGGTGGGCCTC
TACGGAGTAACTCCCTAGT -> ACGGAGTAACTCCCTAGTT
TACGGCATCCCCGGGATGG -> ACGGCATCCCCGGGATGGT
TACGGGTACAAGAACGGTC -> ACGGGTACAAGAACGGTCC
TACGGTTCCATACTTTCAT -> ACGGTTCCATACTTTCATC
TACGTAAACGAGATGCCAC -> ACGTAAACGAGATGCCACA
TACGTACTAGCACTTTGCA -> ACGTACTAGCACTTTGCAT
TACTAAACCCAATACTTGA -> ACTAAACCCAATACTTGAG
TACTAAGTTTAACCCAGCG -> ACTAAGTTTAACCCAGCGG
TACTAGCACTTTGCATATG -> ACTAGCACTTTGCATATGA
TACTAGGCCGCCCATAATT -> ACTAGGCCGCCCATAATTT
TACTGCATCAAGTACCAGC -> ACTGCATCAAGTACCAGCG
TACTGGCCTGCTAGCGACG -> ACTGGCCTGCTAGCGACGA
TACTTAAACTACCCCAACG -> ACTTAAACTACCCCAACGG
TACTTAAGCATGTCGTTAA -> ACTTAAGCATGTCGTTAAC
TACTTGAGGTGGGATCGGA -> ACTTGAGGTGGGATCGGAC
TACTTTCATCTTATGCACG -> ACTTTCATCTTATGCACGA
TAGAATACGCTACAAGGTG -> AGAATACGCTACAAGGTGG
TAGATCTGGGGGTTGTGGA -> AGATCTGGGGGTTGTGGAA
TAGATGCCAATCGCTGACA -> AGATGCCAATCGCTGACAG
TAGCAATTTGCAAACTGTA -> AGCAATTTGCAAACTGTAA
TAGCACAGTTCACAGATCC -> AGCACAGTTCACAGATCCC
TAGCACTTTGCATATGAAG -> AGCACTTTGCATATGAAGC
TAGCCTTACCCGTCACTGA -> AGCCTTACCCGTCACTGAA
TAGCGACGAAACGAGCATT -> AGCGACGAAACGAGCATTG
TAGCGCTCGTGTGCCCAGA -> AGCGCTCGTGTGCCCAGAA
TAGGCCGCCCATAATTTGG -> AGGCCGCCCATAATTTGGG
TAGGGACTAGGGATGCCTA -> AGGGACTAGGGATGCCTAC
TAGGGATCGACTGCTGCTG -> AGGGATCGACTGCTGCTGT
TAGGGATGCCTACGGGTAC -> AGGGATGCCTACGGGTACA
TAGGTATGTCACAATCGCC -> AGGTATGTCACAATCGCCA
TAGTCAGACCTGTTCAGGC -> AGTCAGACCTGTTCAGGCG
TAGTGGCCACAGGCAACCT -> AGTGGCCACAGGCAACCTC
TAGTTATACCGCGCAGTAA -> AGTTATACCGCGCAGTAAG
TAGTTTATTCGGTGCCCTT -> AGTTTATTCGGTGCCCTTC
TATAACTCATAATCATGAG -> ATAACTCATAATCATGAGT
TATACCATTGAGAGCATAA -> ATACCATTGAGAGCATAAT
TATACCGCGCAGTAAGGCA -> ATACCGCGCAGTAAGGCAT
TATACGTAAACGAGATGCC -> ATACGTAAACGAGATGCCA
TATCCACTGGGGGGCAGCT -> ATCCACTGGGGGGCAGCTT
TATCCTAACTCGTAAGGCA -> ATCCTAACTCGTAAGGCAT
TATCCTACTGGCCTGCTAG -> ATCCTACTGGCCTGCTAGC
TATCGAGATACATCCCCGG -> ATCGAGATACATCCCCGGG
TATCGTATCCACTGGGGGG -> ATCGTATCCACTGGGGGGC
TATCTGCACCAATATAACT -> ATCTGCACCAATATAACTC
TATGAAGCATAAGCGAGAC -> ATGAAGCATAAGCGAGACT
TATGAGAAGGAGCTGCCGC -> ATGAGAAGGAGCTGCCGCT
TATGATAACACCAATTTGA -> ATGATAACACCAATTTGAA
TATGATAATCGGGACTAGT -> ATGATAATCGGGACTAGTT
TATGCACGACGACGGTTTC -> ATGCACGACGACGGTTTCG
TATGCCAGCTTCAGGCTGT -> ATGCCAGCTTCAGGCTGTT
TATGGCCTTACGGTTCCAT -> ATGGCCTTACGGTTCCATA
TATGTACGAAGTGACTTGC -> ATGTACGAAGTGACTTGCG
TATGTCACAATCGCCAGTA -> ATGTCACAATCGCCAGTAA
TATTACAATGTCCATCCCC -> ATTACAATGTCCATCCCCG
TATTCGCTGGTCATACAGA -> ATTCGCTGGTCATACAGAG
TATTCGGTGCCCTTCAACT -> ATTCGGTGCCCTTCAACTG
TATTCGTGGGAGTTGCGGT -> ATTCGTGGGAGTTGCGGTC
TATTTCAAACTGGCCGCGG -> ATTTCAAACTGGCCGCGGC
TATTTGCATACCGTCTAGT -> ATTTGCATACCGTCTAGTG
TCAAAATGTTATGAGAAGG -> CAAAATGTTATGAGAAGGA
TCAAACTGGCCGCGGCATG -> CAAACTGGCCGCGGCATGT
TCAACCATCCCTGAGCAAC -> CAACCATCCCTGAGCAACG
TCAACGATAACGGATTCAT -> CAACGATAACGGATTCATC
TCAACTGATCCTCATGGTC -> CAACTGATCCTCATGGTCT
TCAAGTACCAGCGTCCGCA -> CAAGTACCAGCGTCCGCAA
TCAAGTGATGGCAGGTAAC -> CAAGTGATGGCAGGTAACT
TCAATACCAATGGGCTTGG -> CAATACCAATGGGCTTGGC
TCAATGAAACTTAAAATCC -> CAATGAAACTTAAAATCCT
TCACAATCGCCAGTAAAAC -> CACAATCGCCAGTAAAACA
TCACAGATCCCGGTCCCCT -> CACAGATCCCGGTCCCCTG
TCACATGAGCTCCTACTTA -> CACATGAGCTCCTACTTAA
TCACCCACTGTAGGGACTA -> CACCCACTGTAGGGACTAG
TCACTGAACTCTTGAAGGC -> CACTGAACTCTTGAAGGCA
TCAGACCTGTTCAGGCGCT -> CAGACCTGTTCAGGCGCTT
TCAGGAACCCTTGTAATTG -> CAGGAACCCTTGTAATTGA
TCAGGCGCTTGCACGACCG -> CAGGCGCTTGCACGACCGT
TCAGGCTGTTGGCAAGACA -> CAGGCTGTTGGCAAGACAT
TCAGGGTGTCCCGGTTTTT -> CAGGGTGTCCCGGTTTTTT
TCAGGTACGAAGCAGGATC -> CAGGTACGAAGCAGGATCC
TCAGTGAAGGGAAACTGCG -> CAGTGAAGGGAAACTGCGT
TCATAATCATGAGTATCCT -> CATAATCATGAGTATCCTA
TCATACAGAGCACCAGTTA -> CATACAGAGCACCAGTTAC
TCATACGGCATCCCCGGGA -> CATACGGCATCCCCGGGAT
TCATCCCCGGGATGGTCCT -> CATCCCCGGGATGGTCCTT
TCATCTTATGCACGACGAC -> CATCTTATGCACGACGACG
TCATGAGTATCCTACTGGC -> CATGAGTATCCTACTGGCC
TCATGCGGAATGGGGTTTA -> CATGCGGAATGGGGTTTAC
TCATGGTCTATTCGTGGGA -> CATGGTCTATTCGTGGGAG
TCCAACAGCGGCGCCTTAC -> CCAACAGCGGCGCCTTACT
TCCAAGGCGAGATTAACGC -> CCAAGGCGAGATTAACGCT
TCCACTGGGGGGCAGCTTA -> CCACTGGGGGGCAGCTTAC
TCCATACTTTCATCTTATG -> CCATACTTTCATCTTATGC
TCCATCCCCGGGATGGTCC -> CCATCCCCGGGATGGTCCT
TCCCAGGGTGACAATCGCA -> CCCAGGGTGACAATCGCAC
TCCCAGTATACGTAAACGA -> CCCAGTATACGTAAACGAG
TCCCATGGTGCCGATTAAT -> CCCATGGTGCCGATTAATC
TCCCCGGGATGGTCCTACC -> CCCCGGGATGGTCCTACCA
TCCCCGGGATGGTCCTCGG -> CCCCGGGATGGTCCTCGGC
TCCCCGGGATGGTCCTGAG -> CCCCGGGATGGTCCTGAGT
TCCCCGGGATGGTCCTTAA -> CCCCGGGATGGTCCTTAAG
TCCCCGTAAGTCTTAGCAA -> CCCCGTAAGTCTTAGCAAT
TCCCCTGGAGGTGGGTTGT -> CCCCTGGAGGTGGGTTGTG
TCCCGCATTCAAAATGTTA -> CCCGCATTCAAAATGTTAT
TCCCGGTCCCCTGGAGGTG -> CCCGGTCCCCTGGAGGTGG
TCCCGGTTTTTTGAATCGA -> CCCGGTTTTTTGAATCGAG
TCCCTAGTTATACCGCGCA -> CCCTAGTTATACCGCGCAG
TCCCTCCTTTGAATAGGGA -> CCCTCCTTTGAATAGGGAT
TCCCTCGCGCATGGATCGT -> CCCTCGCGCATGGATCGTT
TCCCTGAGCAACGGTTTGG -> CCCTGAGCAACGGTTTGGT
TCCGAGTGAAGTCTATCCT -> CCGAGTGAAGTCTATCCTA
TCCGCAAGTTTGTTTTAGC -> CCGCAAGTTTGTTTTAGCG
TCCGGGCCATGTCCCGCAT -> CCGGGCCATGTCCCGCATT
TCCTAACTCGTAAGGCATC -> CCTAACTCGTAAGGCATCG
TCCTACCAATACGCATGGC -> CCTACCAATACGCATGGCC
TCCTACTGGCCTGCTAGCG -> CCTACTGGCCTGCTAGCGA
TCCTACTTAAGCATGTCGT -> CCTACTTAAGCATGTCGTT
TCCTCATGGTCTATTCGTG -> CCTCATGGTCTATTCGTGG
TCCTCGGCGCCCCGTTGGC -> CCTCGGCGCCCCGTTGGCC
TCCTGAGTTTAACCCTGGC -> CCTGAGTTTAACCCTGGCC
TCCTGGGATACCATAAGGG -> CCTGGGATACCATAAGGGC
TCCTTAAGTGGAATCTGGC -> CCTTAAGTGGAATCTGGCC
TCCTTCGTAGCCTTACCCG -> CCTTCGTAGCCTTACCCGT
TCCTTGATACCAGCCAGAA -> CCTTGATACCAGCCAGAAC
TCCTTTGAATAGGGATCGA -> CCTTTGAATAGGGATCGAC
TCGACTGCTGCTGTCGAGC -> CGACTGCTGCTGTCGAGCT
TCGAGATACATCCCCGGGA -> CGAGATACATCCCCGGGAT
TCGAGCAGGCGCGGACCAG -> CGAGCAGGCGCGGACCAGT
TCGAGCTCTCAGTGAAGGG -> CGAGCTCTCAGTGAAGGGA
TCGCAAGATTCTCCTTCGT -> CGCAAGATTCTCCTTCGTA
TCGCACATCCGGGCCATGT -> CGCACATCCGGGCCATGTC
TCGCACTTGGGTCTATGAT -> CGCACTTGGGTCTATGATA
TCGCAGTACACGCTGGGTC -> CGCAGTACACGCTGGGTCG
TCGCCAGTAAAACAACAGG -> CGCCAGTAAAACAACAGGC
TCGCGCATGGATCGTTTCA -> CGCGCATGGATCGTTTCAA
TCGCGCGAGGCGTGGGGGC -> CGCGCGAGGCGTGGGGGCA
TCGCGTGGGTGCGCACACA -> CGCGTGGGTGCGCACACAC
TCGCTGACAGGTCATACGG -> CGCTGACAGGTCATACGGC
TCGCTGGTCATACAGAGCA -> CGCTGGTCATACAGAGCAC
TCGGACGGGTGACGCAGTA -> CGGACGGGTGACGCAGTAG
TCGGCCATGTTCAATACCA -> CGGCCATGTTCAATACCAA
TCGGCGCCCCGTTGGCCAC -> CGGCGCCCCGTTGGCCACA
TCGGGAAGCTGTCTCTGCT -> CGGGAAGCTGTCTCTGCTT
TCGGGACTAGTTTATTCGG -> CGGGACTAGTTTATTCGGT
TCGGGTTACTAGGCCGCCC -> CGGGTTACTAGGCCGCCCA
TCGGTGCCCTTCAACTGAT -> CGGTGCCCTTCAACTGATC
TCGGTGGATGCGAGCCATC -> CGGTGGATGCGAGCCATCC
TCGTAAGGCATCGCGCGAG -> CGTAAGGCATCGCGCGAGG
TCGTAGCCTTACCCGTCAC -> CGTAGCCTTACCCGTCACT
TCGTATCCACTGGGGGGCA -> CGTATCCACTGGGGGGCAG
TCGTCATGCGGAATGGGGT -> CGTCATGCGGAATGGGGTT
TCGTCGTGGAGATGATCCC -> CGTCGTGGAGATGATCCCT
TCGTGGAGATGATCCCTCC -> CGTGGAGATGATCCCTCCT
TCGTGGGAGTTGCGGTCAG -> CGTGGGAGTTGCGGTCAGG
TCGTGTGCCCAGAACATAA -> CGTGTGCCCAGAACATAAA
TCGTTAACAAAGAGCTATC -> CGTTAACAAAGAGCTATCG
TCGTTTCAACCATCCCTGA -> CGTTTCAACCATCCCTGAG
TCTACGTACTAGCACTTTG -> CTACGTACTAGCACTTTGC
TCTAGTGGCCACAGGCAAC -> CTAGTGGCCACAGGCAACC
TCTATCCTAACTCGTAAGG -> CTATCCTAACTCGTAAGGC
TCTATGATAACACCAATTT -> CTATGATAACACCAATTTG
TCTATGATAATCGGGACTA -> CTATGATAATCGGGACTAG
TCTATTCGTGGGAGTTGCG -> CTATTCGTGGGAGTTGCGG
TCTCAGTGAAGGGAAACTG -> CTCAGTGAAGGGAAACTGC
TCTCCCTCGCGCATGGATC -> CTCCCTCGCGCATGGATCG
TCTCCTTCGTAGCCTTACC -> CTCCTTCGTAGCCTTACCC
TCTCTGAGAGCGGGGGTTG -> CTCTGAGAGCGGGGGTTGT
TCTCTGCTTGCCCCAGTGT -> CTCTGCTTGCCCCAGTGTA
TCTGAGAGCGGGGGTTGTC -> CTGAGAGCGGGGGTTGTCG
TCTGCAATGCCGCTCGGGA -> CTGCAATGCCGCTCGGGAA
TCTGCACCAATATAACTCA -> CTGCACCAATATAACTCAT
TCTGCATACTGCATCAAGT -> CTGCATACTGCATCAAGTA
TCTGCTTGCCCCAGTGTAT -> CTGCTTGCCCCAGTGTATT
TCTGGCCACACTGCAAAAC -> CTGGCCACACTGCAAAACT
TCTGGGGGTTGTGGAACAG -> CTGGGGGTTGTGGAACAGG
TCTTAGCAATTTGCAAACT -> CTTAGCAATTTGCAAACTG
TCTTATGCACGACGACGGT -> CTTATGCACGACGACGGTT
TCTTGAAGGCAATAAAGTA -> CTTGAAGGCAATAAAGTAA
TCTTTCAATGAAACTTAAA -> CTTTCAATGAAACTTAAAA
TCTTTTTCCCATGGTGCCG -> CTTTTTCCCATGGTGCCGA
TGAAACTTAAAATCCTGGG -> GAAACTTAAAATCCTGGGA
TGAACTCTTGAAGGCAATA -> GAACTCTTGAAGGCAATAA
TGAAGCATAAGCGAGACTC -> GAAGCATAAGCGAGACTCG
TGAAGGCAATAAAGTAAAC -> GAAGGCAATAAAGTAAACA
TGAAGGCAGTGTATTCGCT -> GAAGGCAGTGTATTCGCTG
TGAAGGGAAACTGCGTGCA -> GAAGGGAAACTGCGTGCAC
TGAAGTACTAAGTTTAACC -> GAAGTACTAAGTTTAACCC
TGAAGTCTATCCTAACTCG -> GAAGTCTATCCTAACTCGT
TGAATAGGGATCGACTGCT -> GAATAGGGATCGACTGCTG
TGAATCGAGCAGGCGCGGA -> GAATCGAGCAGGCGCGGAC
TGAATCTACGTACTAGCAC -> GAATCTACGTACTAGCACT
TGACAATCGCACTTGGGTC -> GACAATCGCACTTGGGTCT
TGACACTCGTCATGCGGAA -> GACACTCGTCATGCGGAAT
TGACAGGTCATACGGCATC -> GACAGGTCATACGGCATCC
TGACGCAGTAGAATACGCT -> GACGCAGTAGAATACGCTA
TGACGGACTTCTTTTTCCC -> GACGGACTTCTTTTTCCCA
TGACGGTAGATGCCAATCG -> GACGGTAGATGCCAATCGC
TGACTTGCGCGTTCCCAGG -> GACTTGCGCGTTCCCAGGG
TGAGAAGGAGCTGCCGCTG -> GAGAAGGAGCTGCCGCTGA
TGAGAGAGAATAGATCTGG -> GAGAGAGAATAGATCTGGG
TGAGAGCATAATGGGCCTC -> GAGAGCATAATGGGCCTCA
TGAGAGCGGGGGTTGTCGG -> GAGAGCGGGGGTTGTCGGT
TGAGCAACGGTTTGGTAAA -> GAGCAACGGTTTGGTAAAC
TGAGCTCCTACTTAAGCAT -> GAGCTCCTACTTAAGCATG
TGAGGGTGGTGTTCTTTCA -> GAGGGTGGTGTTCTTTCAA
TGAGGTGGGATCGGACGGG -> GAGGTGGGATCGGACGGGT
TGAGTATCCTACTGGCCTG -> GAGTATCCTACTGGCCTGC
TGAGTTTAACCCTGGCCAC -> GAGTTTAACCCTGGCCACA
TGATAACACCAATTTGAAG -> GATAACACCAATTTGAAGG
TGATAATCGGGACTAGTTT -> GATAATCGGGACTAGTTTA
TGATACCAGCCAGAACAAG -> GATACCAGCCAGAACAAGG
TGATCCCTCCTTTGAATAG -> GATCCCTCCTTTGAATAGG
TGATCCTCATGGTCTATTC -> GATCCTCATGGTCTATTCG
TGATGGCAGGTAACTGCTC -> GATGGCAGGTAACTGCTCA
TGCAAAACTAACGCGGTAT -> GCAAAACTAACGCGGTATC
TGCAAAACTAGCACAGTTC -> GCAAAACTAGCACAGTTCA
TGCAAAACTATGTACGAAG -> GCAAAACTATGTACGAAGT
TGCAAACTGAATCTACGTA -> GCAAACTGAATCTACGTAC
TGCAAACTGTAATACAGGA -> GCAAACTGTAATACAGGAG
TGCAATGCCGCTCGGGAAG -> GCAATGCCGCTCGGGAAGC
TGCACCAATATAACTCATA -> GCACCAATATAACTCATAA
TGCACCTCCTTGATACCAG -> GCACCTCCTTGATACCAGC
TGCACGACCGTTTTGGCGC -> GCACGACCGTTTTGGCGCG
TGCACGACGACGGTTTCGC -> GCACGACGACGGTTTCGCG
TGCATACCGTCTAGTGGCC -> GCATACCGTCTAGTGGCCA
TGCATACTGCATCAAGTAC -> GCATACTGCATCAAGTACC
TGCATATGAAGCATAAGCG -> GCATATGAAGCATAAGCGA
TGCATCAAGTACCAGCGTC -> GCATCAAGTACCAGCGTCC
TGCCAATCGCTGACAGGTC -> GCCAATCGCTGACAGGTCA
TGCCACACTAATCGTCGTG -> GCCACACTAATCGTCGTGG
TGCCAGCTTCAGGCTGTTG -> GCCAGCTTCAGGCTGTTGG
TGCCCAGAACATAAATATG -> GCCCAGAACATAAATATGC
TGCCCCAGTGTATTACAAT -> GCCCCAGTGTATTACAATG
TGCCCTTCAACTGATCCTC -> GCCCTTCAACTGATCCTCA
TGCCGATTAATCTGCATAC -> GCCGATTAATCTGCATACT
TGCCGCTCGGGAAGCTGTC -> GCCGCTCGGGAAGCTGTCT
TGCCGCTGACGGTAGATGC -> GCCGCTGACGGTAGATGCC
TGCCTACGGGTACAAGAAC -> GCCTACGGGTACAAGAACG
TGCGAGCCATCCAACAGCG -> GCGAGCCATCCAACAGCGG
TGCGCACACACGTCGGCCA -> GCGCACACACGTCGGCCAT
TGCGCGTTCCCAGGGTGAC -> GCGCGTTCCCAGGGTGACA
TGCGGAATGGGGTTTACAA -> GCGGAATGGGGTTTACAAT
TGCGGTCAGGGTGTCCCGG -> GCGGTCAGGGTGTCCCGGT
TGCGTGCACCTCCTTGATA -> GCGTGCACCTCCTTGATAC
TGCTAGCGACGAAACGAGC -> GCTAGCGACGAAACGAGCA
TGCTCAGGTACGAAGCAGG -> GCTCAGGTACGAAGCAGGA
TGCTGCTGTCGAGCTCTCA -> GCTGCTGTCGAGCTCTCAG
TGCTGTCGAGCTCTCAGTG -> GCTGTCGAGCTCTCAGTGA
TGCTTGCCCCAGTGTATTA -> GCTTGCCCCAGTGTATTAC
TGGAACAGGCGACTAATTA -> GGAACAGGCGACTAATTAT
TGGAATCTGGCCACACTGC -> GGAATCTGGCCACACTGCA
TGGACCGAACGGGTTACTT -> GGACCGAACGGGTTACTTA
TGGACGGGAGGCGACCAAC -> GGACGGGAGGCGACCAACC
TGGAGATGATCCCTCCTTT -> GGAGATGATCCCTCCTTTG
TGGAGGTGGGTTGTGGCTG -> GGAGGTGGGTTGTGGCTGC
TGGATCGTTTCAACCATCC -> GGATCGTTTCAACCATCCC
TGGATCTCTGAGAGCGGGG -> GGATCTCTGAGAGCGGGGG
TGGATGCGAGCCATCCAAC -> GGATGCGAGCCATCCAACA
TGGCAAGACATATCTGCAC -> GGCAAGACATATCTGCACC
TGGCAGCAGGAATAATAGG -> GGCAGCAGGAATAATAGGT
TGGCAGGTAACTGCTCAGG -> GGCAGGTAACTGCTCAGGT
TGGCCACACTGCAAAACTA -> GGCCACACTGCAAAACTAT, GGCCACACTGCAAAACTAG, GGCCACACTGCAAAACTAT, GGCCACACTGCAAAACTAA
TGGCCACAGGCAACCTCAC -> GGCCACAGGCAACCTCACC
TGGCCGCGGCATGTCAAGT -> GGCCGCGGCATGTCAAGTG
TGGCCTGCTAGCGACGAAA -> GGCCTGCTAGCGACGAAAC
TGGCCTTACGGTTCCATAC -> GGCCTTACGGTTCCATACT
TGGCGCGGCCGGGCATATG -> GGCGCGGCCGGGCATATGG
TGGCTGCAAACTGAATCTA -> GGCTGCAAACTGAATCTAC
TGGGAGTTGCGGTCAGGGT -> GGGAGTTGCGGTCAGGGTG
TGGGATACCATAAGGGCGT -> GGGATACCATAAGGGCGTA
TGGGATCGGACGGGTGACG -> GGGATCGGACGGGTGACGC
TGGGCCTCACATGAGCTCC -> GGGCCTCACATGAGCTCCT
TGGGCCTCAGGAACCCTTG -> GGGCCTCAGGAACCCTTGT
TGGGCTGGGGTGGGTTAAC -> GGGCTGGGGTGGGTTAACA
TGGGCTTGGCAGCAGGAAT -> GGGCTTGGCAGCAGGAATA
TGGGGGCACGGACGAAGGC -> GGGGGCACGGACGAAGGCG
TGGGGGGCAGCTTACACAA -> GGGGGGCAGCTTACACAAT
TGGGGGTTGTGGAACAGGC -> GGGGGTTGTGGAACAGGCG
TGGGGTGGGTTAACATGGA -> GGGGTGGGTTAACATGGAC
TGGGGTTTACAATATACCA -> GGGGTTTACAATATACCAT
TGGGTCGCAAGATTCTCCT -> GGGTCGCAAGATTCTCCTT
TGGGTCTATGATAATCGGG -> GGGTCTATGATAATCGGGA
TGGGTGCGCACACACGTCG -> GGGTGCGCACACACGTCGG
TGGGTTAACATGGACGGGA -> GGGTTAACATGGACGGGAG
TGGGTTGTGGCTGCAAACT -> GGGTTGTGGCTGCAAACTG
TGGTAAACAGCGGGCCTTG -> GGTAAACAGCGGGCCTTGA
TGGTCATACAGAGCACCAG -> GGTCATACAGAGCACCAGT
TGGTCCTACCAATACGCAT -> GGTCCTACCAATACGCATG
TGGTCCTCGGCGCCCCGTT -> GGTCCTCGGCGCCCCGTTG
TGGTCCTGAGTTTAACCCT -> GGTCCTGAGTTTAACCCTG
TGGTCCTTAAGTGGAATCT -> GGTCCTTAAGTGGAATCTG
TGGTCTATTCGTGGGAGTT -> GGTCTATTCGTGGGAGTTG
TGGTGCCGATTAATCTGCA -> GGTGCCGATTAATCTGCAT
TGGTGTTCTTTCAATGAAA -> GGTGTTCTTTCAATGAAAC
TGGTTGGATCTCTGAGAGC -> GGTTGGATCTCTGAGAGCG
TGTAATACAGGAGATGGAC -> GTAATACAGGAGATGGACC
TGTAATGACACTCGTCATG -> GTAATGACACTCGTCATGC
TGTAATTGAGGGTGGTGTT -> GTAATTGAGGGTGGTGTTC
TGTACGAAGTGACTTGCGC -> GTACGAAGTGACTTGCGCG
TGTAGGGACTAGGGATGCC -> GTAGGGACTAGGGATGCCT
TGTATTACAATGTCCATCC -> GTATTACAATGTCCATCCC
TGTATTCGCTGGTCATACA -> GTATTCGCTGGTCATACAG
TGTCAAGTGATGGCAGGTA -> GTCAAGTGATGGCAGGTAA
TGTCACAATCGCCAGTAAA -> GTCACAATCGCCAGTAAAA
TGTCCATCCCCGGGATGGT -> GTCCATCCCCGGGATGGTC
TGTCCCGCATTCAAAATGT -> GTCCCGCATTCAAAATGTT
TGTCCCGGTTTTTTGAATC -> GTCCCGGTTTTTTGAATCG
TGTCGAGCTCTCAGTGAAG -> GTCGAGCTCTCAGTGAAGG
TGTCGGTGGATGCGAGCCA -> GTCGGTGGATGCGAGCCAT
TGTCGTTAACAAAGAGCTA -> GTCGTTAACAAAGAGCTAT
TGTCTCTGCTTGCCCCAGT -> GTCTCTGCTTGCCCCAGTG
TGTGACGGACTTCTTTTTC -> GTGACGGACTTCTTTTTCC
TGTGCCCAGAACATAAATA -> GTGCCCAGAACATAAATAT
TGTGGAACAGGCGACTAAT -> GTGGAACAGGCGACTAATT
TGTGGCTGCAAACTGAATC -> GTGGCTGCAAACTGAATCT
TGTTATGAGAAGGAGCTGC -> GTTATGAGAAGGAGCTGCC
TGTTCAATACCAATGGGCT -> GTTCAATACCAATGGGCTT
TGTTCAGGCGCTTGCACGA -> GTTCAGGCGCTTGCACGAC
TGTTCTTTCAATGAAACTT -> GTTCTTTCAATGAAACTTA
TGTTGGCAAGACATATCTG -> GTTGGCAAGACATATCTGC
TGTTTTAGCGCTCGTGTGC -> GTTTTAGCGCTCGTGTGCC
TTAAAATCCTGGGATACCA -> TAAAATCCTGGGATACCAT
TTAAACTACCCCAACGGCG -> TAAACTACCCCAACGGCGG
TTAACAAAGAGCTATCGAG -> TAACAAAGAGCTATCGAGA
TTAACATGGACGGGAGGCG -> TAACATGGACGGGAGGCGA
TTAACCCAGCGGGGATGGT -> TAACCCAGCGGGGATGGTT
TTAACCCTGGCCACACTGC -> TAACCCTGGCCACACTGCA
TTAACGCTCGCACATCCGG -> TAACGCTCGCACATCCGGG
TTAAGCATGTCGTTAACAA -> TAAGCATGTCGTTAACAAA
TTAAGTGGAATCTGGCCAC -> TAAGTGGAATCTGGCCACA
TTAATCTGCATACTGCATC -> TAATCTGCATACTGCATCA
TTACAATATACCATTGAGA -> TACAATATACCATTGAGAG
TTACAATGTCCATCCCCGG -> TACAATGTCCATCCCCGGG
TTACACAATTTCTATGATA -> TACACAATTTCTATGATAA
TTACCCGTCACTGAACTCT -> TACCCGTCACTGAACTCTT
TTACGATAACGCTGTAATG -> TACGATAACGCTGTAATGA
TTACGGTTCCATACTTTCA -> TACGGTTCCATACTTTCAT
TTACTAAACCCAATACTTG -> TACTAAACCCAATACTTGA
TTACTAGGCCGCCCATAAT -> TACTAGGCCGCCCATAATT
TTACTTAAACTACCCCAAC -> TACTTAAACTACCCCAACG
TTAGCAATTTGCAAACTGT -> TAGCAATTTGCAAACTGTA
TTAGCGCTCGTGTGCCCAG -> TAGCGCTCGTGTGCCCAGA
TTATACCGCGCAGTAAGGC -> TATACCGCGCAGTAAGGCA
TTATGAGAAGGAGCTGCCG -> TATGAGAAGGAGCTGCCGC
TTATGCACGACGACGGTTT -> TATGCACGACGACGGTTTC
TTATTCGGTGCCCTTCAAC -> TATTCGGTGCCCTTCAACT
TTATTTGCATACCGTCTAG -> TATTTGCATACCGTCTAGT
TTCAAAATGTTATGAGAAG -> TCAAAATGTTATGAGAAGG
TTCAAACTGGCCGCGGCAT -> TCAAACTGGCCGCGGCATG
TTCAACCATCCCTGAGCAA -> TCAACCATCCCTGAGCAAC
TTCAACTGATCCTCATGGT -> TCAACTGATCCTCATGGTC
TTCAATACCAATGGGCTTG -> TCAATACCAATGGGCTTGG
TTCAATGAAACTTAAAATC -> TCAATGAAACTTAAAATCC
TTCACAGATCCCGGTCCCC -> TCACAGATCCCGGTCCCCT
TTCAGGCGCTTGCACGACC -> TCAGGCGCTTGCACGACCG
TTCAGGCTGTTGGCAAGAC -> TCAGGCTGTTGGCAAGACA
TTCATCCCCGGGATGGTCC -> TCATCCCCGGGATGGTCCT
TTCATCTTATGCACGACGA -> TCATCTTATGCACGACGAC
TTCCATACTTTCATCTTAT -> TCCATACTTTCATCTTATG
TTCCCAGGGTGACAATCGC -> TCCCAGGGTGACAATCGCA
TTCCCATGGTGCCGATTAA -> TCCCATGGTGCCGATTAAT
TTCGCGTGGGTGCGCACAC -> TCGCGTGGGTGCGCACACA
TTCGCTGGTCATACAGAGC -> TCGCTGGTCATACAGAGCA
TTCGGTGCCCTTCAACTGA -> TCGGTGCCCTTCAACTGAT
TTCGTAGCCTTACCCGTCA -> TCGTAGCCTTACCCGTCAC
TTCGTGGGAGTTGCGGTCA -> TCGTGGGAGTTGCGGTCAG
TTCTATGATAACACCAATT -> TCTATGATAACACCAATTT
TTCTCCTTCGTAGCCTTAC -> TCTCCTTCGTAGCCTTACC
TTCTTTCAATGAAACTTAA -> TCTTTCAATGAAACTTAAA
TTCTTTTTCCCATGGTGCC -> TCTTTTTCCCATGGTGCCG
TTGAAGGCAATAAAGTAAA -> TGAAGGCAATAAAGTAAAC
TTGAAGGCAGTGTATTCGC -> TGAAGGCAGTGTATTCGCT
TTGAAGTACTAAGTTTAAC -> TGAAGTACTAAGTTTAACC
TTGAATAGGGATCGACTGC -> TGAATAGGGATCGACTGCT
TTGAATCGAGCAGGCGCGG -> TGAATCGAGCAGGCGCGGA
TTGAGAGAGAATAGATCTG -> TGAGAGAGAATAGATCTGG
TTGAGAGCATAATGGGCCT -> TGAGAGCATAATGGGCCTC
TTGAGGGTGGTGTTCTTTC -> TGAGGGTGGTGTTCTTTCA
TTGAGGTGGGATCGGACGG -> TGAGGTGGGATCGGACGGG
TTGATACCAGCCAGAACAA -> TGATACCAGCCAGAACAAG
TTGCAAACTGTAATACAGG -> TGCAAACTGTAATACAGGA
TTGCACGACCGTTTTGGCG -> TGCACGACCGTTTTGGCGC
TTGCATACCGTCTAGTGGC -> TGCATACCGTCTAGTGGCC
TTGCATATGAAGCATAAGC -> TGCATATGAAGCATAAGCG
TTGCCCCAGTGTATTACAA -> TGCCCCAGTGTATTACAAT
TTGCGCGTTCCCAGGGTGA -> TGCGCGTTCCCAGGGTGAC
TTGCGGTCAGGGTGTCCCG -> TGCGGTCAGGGTGTCCCGG
TTGGATCTCTGAGAGCGGG -> TGGATCTCTGAGAGCGGGG
TTGGCAAGACATATCTGCA -> TGGCAAGACATATCTGCAC
TTGGCAGCAGGAATAATAG -> TGGCAGCAGGAATAATAGG
TTGGCCACACTGCAAAACT -> TGGCCACACTGCAAAACTA
TTGGCGCGGCCGGGCATAT -> TGGCGCGGCCGGGCATATG
TTGGGCTGGGGTGGGTTAA -> TGGGCTGGGGTGGGTTAAC
TTGGGTCTATGATAATCGG -> TGGGTCTATGATAATCGGG
TTGGTAAACAGCGGGCCTT -> TGGTAAACAGCGGGCCTTG
TTGTAATTGAGGGTGGTGT -> TGTAATTGAGGGTGGTGTT
TTGTCGGTGGATGCGAGCC -> TGTCGGTGGATGCGAGCCA
TTGTGGAACAGGCGACTAA -> TGTGGAACAGGCGACTAAT
TTGTGGCTGCAAACTGAAT -> TGTGGCTGCAAACTGAATC
TTGTTTTAGCGCTCGTGTG -> TGTTTTAGCGCTCGTGTGC
TTTAACCCAGCGGGGATGG -> TTAACCCAGCGGGGATGGT
TTTAACCCTGGCCACACTG -> TTAACCCTGGCCACACTGC
TTTACAATATACCATTGAG -> TTACAATATACCATTGAGA
TTTAGCGCTCGTGTGCCCA -> TTAGCGCTCGTGTGCCCAG
TTTATTCGGTGCCCTTCAA -> TTATTCGGTGCCCTTCAAC
TTTCAAACTGGCCGCGGCA -> TTCAAACTGGCCGCGGCAT
TTTCAACCATCCCTGAGCA -> TTCAACCATCCCTGAGCAA
TTTCAATGAAACTTAAAAT -> TTCAATGAAACTTAAAATC
TTTCATCTTATGCACGACG -> TTCATCTTATGCACGACGA
TTTCCCATGGTGCCGATTA -> TTCCCATGGTGCCGATTAA
TTTCGCGTGGGTGCGCACA -> TTCGCGTGGGTGCGCACAC
TTTCTATGATAACACCAAT -> TTCTATGATAACACCAATT
TTTGAAGGCAGTGTATTCG -> TTGAAGGCAGTGTATTCGC
TTTGAATAGGGATCGACTG -> TTGAATAGGGATCGACTGC
TTTGAATCGAGCAGGCGCG -> TTGAATCGAGCAGGCGCGG
TTTGCAAACTGTAATACAG -> TTGCAAACTGTAATACAGG
TTTGCATACCGTCTAGTGG -> TTGCATACCGTCTAGTGGC
TTTGCATATGAAGCATAAG -> TTGCATATGAAGCATAAGC
TTTGGCGCGGCCGGGCATA -> TTGGCGCGGCCGGGCATAT
TTTGGGCTGGGGTGGGTTA -> TTGGGCTGGGGTGGGTTAA
TTTGGTAAACAGCGGGCCT -> TTGGTAAACAGCGGGCCTT
TTTGTTTTAGCGCTCGTGT -> TTGTTTTAGCGCTCGTGTG
TTTTAGCGCTCGTGTGCCC -> TTTAGCGCTCGTGTGCCCA
TTTTCCCATGGTGCCGATT -> TTTCCCATGGTGCCGATTA
TTTTGAATCGAGCAGGCGC -> TTTGAATCGAGCAGGCGCG
TTTTGGCGCGGCCGGGCAT -> TTTGGCGCGGCCGGGCATA
TTTTTCCCATGGTGCCGAT -> TTTTCCCATGGTGCCGATT
TTTTTGAATCGAGCAGGCG -> TTTTGAATCGAGCAGGCGC
TTTTTTGAATCGAGCAGGC -> TTTTTGAATCGAGCAGGCG
